与	q
他	w
有	e
我	r
和	t
就	y
里	u
小	i
那	o
着	p
从	a
中	s
在	d
你	f
不	g
上	h
是	j
的	k
为	l
来	x
这	c
她	v
了	b
以	n
也	m
说	yd
都	fj
对	en
地	fm
而	dm
人	wo
去	lh
一	gi
要	sv
被	bh
把	rj
但	wj
会	oc
让	yh
还	gp
得	hx
时	jf
到	aj
看	me
等	tf
却	lb
后	fk
将	uq
之	pp
想	tn
能	jx
好	vb
用	eh
可	sk
大	do
给	xw
下	gh
啊	kb
又	cn
尘	if
年	ak
向	bk
当	iv
吧	kj
才	ft
道	qp
所	lr
并	ue
或	xk
牧	nt
者	fjd
比	ax
太	du
再	ke
前	uw
苏	al
打	rs
便	wg
其	hg
最	jb
您	fi
爱	jd
它	px
由	na
很	hv
哦	kr
元	fq
萧	av
叶	kf
月	ee
做	wd
过	fy
如	vk
韩	kv
洛	io
点	vo
于	fh
多	qo
天	gd
像	wl
王	gg
第	tx
更	gj
林	meo
亲	ui
呢	kn
炎	oo
跟	lv
三	di
走	kg
家	pe
已	ly
日	ja
二	fio
连	lp
及	ey
张	xh
边	lpi
手	ch
没	ix
问	uk
只	ku
老	fx
谁	yr
无	fs
李	sb
出	bm
新	uir
十	fo
个	ot
笑	tm
若	at
风	nr
四	li
们	wu
陈	ba
请	yg
心	ni
该	ya
周	mf
因	ld
儿	qq
叫	knh
脸	ew
先	eq
自	tt
修	wh
成	pxy
少	it
水	hi
白	kt
真	fe
内	mw
则	mj
正	gc
使	wr
五	si
锐	qd
头	iw
性	np
处	th
血	tl
灵	vou
高	hk
非	mx
吃	ks
两	ea
间	uj
云	cg
见	ms
子	bo
明	je
钱	qg
起	kl
唐	ow
声	fn
路	lo
海	cu
山	mm
阿	bs
往	hb
开	eo
凌	uf
听	krh
令	dy
未	fii
越	ka
百	dj
沈	ip
刘	cj
长	hs
回	lk
金	bu
别	vj
本	jj
龙	dx
花	ah
拿	wc
美	ug
神	oj
应	oq
峰	mt
带	mp
同	ma
君	vt
生	pg
冷	ud
楚	mwu
雨	mk
经	xc
动	cl
卿	qt
方	py
梦	mq
罗	lq
黄	an
女	vv
住	wb
号	kw
死	bx
即	vbh
外	qh
市	vm
剑	wq
找	rx
黑	bb
秦	dw
至	ag
吗	kc
蓝	ajl
快	nb
总	dn
战	vx
法	il
夜	yw
刚	mr
七	ao
万	gq
清	ig
发	hd
喝	kjq
放	pt
某	af
飞	nu
名	qk
杨	svt
么	og
夏	dh
许	yrh
且	ehn
魏	tv
宁	ps
光	kh
雷	fl
书	hby
分	mv
北	ux
火	oy
璃	gy
徐	hw
曾	lj
柳	sq
呀	krt
何	ws
凡	ntn
雪	fv
六	uo
车	lg
各	oa
进	xp
赵	kri
慕	siy
此	cx
全	ox
江	ia
话	yq
受	jc
陆	bf
门	uy
倒	wa
买	ci
马	co
红	xa
拉	ru
写	pq
安	pv
化	ht
区	ar
跑	lql
按	rp
岁	mqu
男	ll
斯	hr
吴	kgd
深	ios
原	dk
讲	yx
华	mxv
魔	vq
行	hwh
坐	afd
亦	pyg
穿	pr
条	ti
县	ec
莫	sg
送	sp
落	ai
九	voa
树	se
青	ge
气	et
古	dg
石	dd
墨	bff
鬼	qc
身	yt
哥	aoe
朝	keg
沐	is
哈	kwg
乔	mjk
孙	bi
主	by
国	lbi
怕	nk
般	ex
伤	wt
嗯	kld
字	pb
几	ntn
啦	kru
作	wk
远	fqp
恩	ldn
痛	uc
西	sgh
加	vn
眼	hvy
米	oao
竟	xq
靠	ek
帮	ob
帝	up
力	la
荣	ap
兰	uff
干	fg
强	xkj
东	aii
师	jk
药	axq
离	yb
浩	ie
文	cy
入	ty
宗	pw
克	dq
德	hl
城	fp
阵	bl
接	ruv
故	dt
千	qtg
留	qy
学	ib
每	xx
哭	xd
事	nv
皓	kek
换	rq
常	jbj
玄	ac
玩	gf
诗	yf
八	mo
果	js
微	hm
感	dr
既	vl
必	no
酒	isg
宋	psu
苦	ad
杀	jt
传	wv
转	lvc
境	fxq
朱	ts
思	ln
秀	te
香	tj
面	dl
难	cr
变	pc
情	ng
蒋	au
半	vu
寒	pu
尹	vte
流	iy
立	uu
重	qu
念	dni
病	uew
拍	rk
尽	nm
虽	kju
轻	lc
秋	to
泪	ih
低	wsc
信	wy
桀	bsu
军	pl
温	ij
菲	am
武	ga
绾	xpd
宝	pbu
忙	ny
活	iq
口	kk
静	geq
费	xj
满	iae
著	afj
些	cxf
欲	mrq
玉	bg
院	bp
源	id
嘴	kcx
空	psf
木	ss
级	xe
似	wn
顾	db
族	pci
今	dty
命	wnj
皇	kgf
平	fu
刀	vnt
田	lhn
相	tg
卡	mh
掉	rh
依	wyk
指	rxj
定	pwu
型	ej
读	yv
数	ov
破	dhc
退	vp
哪	ko
喜	fa
冲	us
斗	wyy
河	isk
画	gl
敢	nbt
近	rpi
完	pf
睡	hq
轰	lou
双	oe
早	vh
嘛	kvy
浪	iyv
期	he
肖	ief
喊	kd
乃	ent
郭	ybb
尔	qi
交	ur
钟	qs
宇	pfh
直	fef
待	hf
收	nh
跳	liq
尸	nn
皆	axk
党	jq
影	ki
兵	rg
愿	dki
歌	aq
仙	wm
乐	qii
谢	yy
吾	skf
厉	dqe
村	sf
言	yyy
约	xqy
潇	iav
特	nf
脚	el
追	td
取	bc
易	jqr
系	txi
答	tw
唱	kjj
度	lci
卖	vi
色	qj
共	rgh
鱼	ct
管	tp
镇	qf
福	or
包	ql
圣	cf
蛇	jp
余	wi
傅	wbf
暗	jxg
阳	bj
枫	sn
巨	and
挺	rqp
佛	wx
齐	cjj
魂	cq
利	tjh
猛	vbl
布	dbk
种	tsh
照	jv
草	avj
紫	cxx
仍	we
抽	rn
背	uxe
纪	xl
招	rv
任	wqg
狗	vs
冰	uh
印	sbh
求	foa
知	ck
晓	jxp
烟	ol
皮	hc
众	wau
瞧	hro
姐	ve
盛	pxyl
错	qa
狼	vy
胡	de
枪	sw
柔	cs
挑	ri
春	dwj
铁	qr
象	le
南	heu
斩	lrh
式	aa
辰	dei
推	rr
教	fb
黎	tq
丝	xxg
闻	ub
抓	ro
望	ye
提	rjw
凤	nc
装	ufy
卫	nx
类	od
翻	ml
嘉	fav
梁	ivm
茶	aw
暴	jr
世	kdd
意	xn
台	ckf
群	vtk
希	rd
单	ul
随	be
灯	os
恨	nvy
沙	ii
站	uv
塔	faw
兮	mwb
合	wty
玦	gb
压	df
夫	aaa
店	ok
丹	my
袁	fkk
莉	atj
博	fbf
称	tqi
兽	ulr
爬	oh
反	rc
丁	sgh
归	jvg
犯	vln
妈	vc
极	sey
殿	nrx
次	ky
怪	ncf
除	bw
响	kbk
左	da
杰	so
格	sog
肉	mi
急	qv
兴	coa
凝	uxc
佳	wf
团	lf
达	dp
抱	rql
爷	mb
星	jpg
界	lw
关	sy
哼	kyb
部	ukb
旧	hj
宫	pk
姜	ugv
氏	snv
淡	ioo
通	ce
线	xg
熊	jxx
章	xf
楼	sov
队	bwy
超	kvk
救	fty
算	tha
民	ne
史	kri
亚	go
现	gm
羡	ugk
谈	yo
啸	kvi
寻	vf
郑	sbh
腿	ev
景	kiu
零	fd
观	cm
纹	xcy
晴	jg
乱	qn
热	ho
程	tk
停	whs
罪	lm
霍	fr
量	jgu
物	nq
然	qdy
借	waj
陪	buk
体	wjg
赶	kfk
件	wp
喂	kle
室	pa
刺	ei
志	fni
贤	tmu
迷	op
洗	ieq
懂	naq
派	ir
船	enk
毒	gx
伯	wkg
射	yfy
建	wfp
疼	ut
凉	uyi
初	bv
奇	ds
银	qvy
亮	hn
养	pj
灰	doi
醉	sya
妖	vmy
沉	ipn
骂	xcf
瑶	ger
永	yi
吹	kq
占	vhg
阴	beg
季	tb
记	yl
藏	aua
虎	hnv
图	lt
庄	of
目	hh
游	ipb
报	riy
毛	cnv
坏	fgy
矣	cc
均	fqu
考	fw
莲	alp
座	oaf
抢	rw
善	pur
汤	ivt
扫	rvg
款	fwm
累	lx
施	pm
尧	xpb
差	pad
公	mc
琪	ghy
猫	va
根	svy
机	snn
终	xt
紧	txiu
姓	vpg
碰	duo
散	ae
胜	ep
梅	sx
杜	sfg
邪	rt
具	eu
结	xfk
办	lmi
省	ith
位	wug
巴	jn
床	osi
洞	im
网	md
骨	xhn
墙	ff
乎	tu
富	prl
母	xs
抬	rck
晨	jde
土	fff
弗	xjk
场	fvt
府	owf
甲	uhn
薛	atd
权	sc
认	ywy
滚	iu
维	xr
鹰	owr
盖	ugl
眉	nhh
弄	gaj
贵	xm
松	sm
需	fdm
够	sqy
侯	wnc
员	km
衣	yk
鸟	qgd
投	rxy
表	gk
引	xhh
保	mkd
咬	kur
曰	jh
司	nrd
祖	oeg
值	wfe
扯	rcg
右	tr
复	tjt
品	kx
撞	ruu
付	wfy
摸	rsy
改	lty
班	gv
实	pi
躲	yn
段	nxy
街	hff
唉	kcc
替	aaj
欣	rqw
波	ihc
广	oty
羽	neo
伍	wsg
幽	xmx
阁	uod
封	fffy
逃	iqp
卷	xlb
笔	tc
烧	oxp
展	nae
查	sj
治	ic
补	bhy
琳	gmy
解	qe
术	syi
甜	qaf
假	wrn
语	ys
艾	aru
房	ope
独	vjy
另	vhn
硬	dgj
容	prf
断	on
穷	plr
项	adm
选	eqp
域	fxk
偷	ww
瑞	gmd
绿	xji
忠	sni
腰	es
牛	ptg
掠	ry
卢	hnr
谷	mrf
贾	smu
琛	gos
惊	nyi
失	rwi
食	hhh
婷	vhs
缘	xxe
尊	usf
涌	ice
觉	ims
整	utg
碎	dya
纳	xmw
案	pvs
严	god
狂	vg
昊	jgd
怀	ngy
暖	jeg
汝	ivg
盘	elf
扑	rhy
川	jth
音	xy
汪	igg
扬	rvt
曼	jl
足	lhny
砰	dfu
形	eet
曹	em
威	dv
准	urg
客	po
菜	aes
泽	icv
勇	cel
怒	vcn
钰	qb
雀	irf
丽	gyu
闪	uwi
傻	wtk
组	xeg
弹	xu
据	rnd
俊	wcm
臣	ay
油	in
旁	upp
尼	nxv
脉	eyi
纸	xsn
晚	jls
纯	xb
底	osc
简	tuj
球	gfy
舞	rl
岳	rgm
砸	dab
递	uxp
久	qyi
牵	dpp
搞	rhk
块	fby
康	owi
灭	goi
支	fc
撒	ra
圈	lxl
状	udy
良	yvu
理	gu
吻	kqr
野	ua
守	pfy
爹	mqu
短	cga
戴	jlr
褚	bfj
恶	gon
露	flo
致	aty
父	mty
雅	rtr
震	fde
颜	ute
伊	wvt
仅	wcy
饭	hrc
唯	krg
吉	fkf
折	rrh
论	ywx
掌	jch
局	ns
叔	mtc
浅	igx
负	qm
止	chg
慢	nj
呆	ksu
敲	hkh
拳	xch
礼	onn
岛	qmk
端	um
汉	icy
词	ynr
罢	llu
须	ed
偏	wom
哎	kar
片	st
升	ta
句	stn
哟	kxq
扎	rnn
踏	lhi
吐	kfg
符	twf
戚	dmt
莱	axi
堂	jff
辉	kp
翔	pn
遂	ueu
绕	xxp
瞳	hu
姬	vay
荷	aws
步	cir
代	hy
托	rm
存	dhb
聚	bcw
锋	qtd
辛	ayg
举	cv
轩	lfh
孟	blf
怎	kfn
吕	kkf
曲	kak
伞	wuh
异	laj
滴	ied
渡	ilc
率	aci
工	agh
刷	nbj
娜	vob
暮	sjf
配	sl
拖	rtm
诸	yfj
圆	lkm
娘	vyv
吸	key
列	bjh
呈	kgf
叹	kcy
殷	rvn
勿	qre
妃	vln
挤	rcj
领	dyd
湖	ide
肯	cef
顶	sd
层	nci
忘	yni
牌	sr
输	lww
注	ibg
细	xlg
燕	auk
瑾	gqf
冯	ucg
舍	bkf
尚	jao
袍	bq
样	sph
敬	as
舒	bkc
蒙	apg
持	rf
玛	gcg
洪	iry
飘	bin
凭	wqn
窗	ptk
锁	qim
岚	mn
碗	dpq
倍	wuk
伟	wvn
争	qsj
迪	npi
防	bpt
翠	nya
绝	xqj
属	ntk
羊	pyt
含	dkf
堆	frg
呼	ktu
智	ckj
忽	qrn
器	xdy
味	kfi
义	yri
宽	pam
杯	sgy
邓	cb
州	ji
彩	ese
兄	kqb
爸	mjb
薄	aib
架	vsu
默	bd
制	ljh
摔	rac
袖	bn
耳	bgh
服	eiy
切	avt
操	rkx
透	tep
席	lbk
略	log
苍	awl
醒	sjp
份	wmv
恒	ngj
己	lll
鲁	cjf
劝	clt
奈	dwm
弯	pxb
厚	djb
降	bt
闹	uvm
愈	wwn
咱	ktg
屋	nad
汗	ifh
孔	bnn
逸	ls
翊	un
溪	iex
宜	pef
胖	evu
弱	xux
娶	bcv
挥	rpl
显	jo
逼	rlp
悦	nd
挂	rff
玲	gdy
於	pwuy
击	fmk
饮	hqw
审	pjh
骗	com
瞪	hwg
顺	jdm
瑜	gw
居	ndd
凯	mln
扣	rkg
董	aqu
痒	upk
首	qyt
减	udr
夕	qtn
甚	hnv
英	amd
虚	hod
唇	dek
稳	tqv
拼	rue
甩	env
遍	om
朵	nsu
基	hff
哲	rrk
围	lvn
桥	smj
熬	gt
赢	yem
额	pod
寄	pd
鸿	iaq
岩	mdf
泰	dwi
麦	gtu
瓦	gn
吼	kbn
摇	re
精	oge
调	ym
雾	ftl
毅	ueux
轮	lwx
冬	tuu
课	yj
阮	bfq
软	lqw
吞	gdk
彼	hhc
乙	nee
副	rlj
曦	ju
角	qej
扶	ray
垂	qag
普	uoj
医	aci
士	fgh
亿	wnn
败	mty
始	vck
孝	fbd
登	wga
池	imn
刻	aoj
猪	vfj
计	yfh
泥	inx
染	ivs
尾	ncn
焉	gcq
森	smu
范	ail
趁	kwe
握	rna
愁	ton
造	ekp
闯	ucd
勾	qci
敌	qty
桌	hjs
伸	wjh
聊	bqt
遇	jm
运	cp
贝	mhn
套	dvu
供	wry
嫁	vpe
忍	vyn
郝	fob
咽	kldy
迎	qbp
尺	nmi
煮	fjo
猜	vge
科	twh
宛	pql
鸡	cqg
告	ekf
证	ygc
慧	dhd
娇	vmj
决	uby
官	pdf
戈	xgn
湿	ijo
肩	oed
擦	rpw
悲	mxn
素	gxi
什	wfh
虞	hkg
脱	edq
承	bdi
鞋	qff
塞	pff
缺	rmb
电	jnv
惠	gjc
抹	rgs
柱	sbg
诺	yat
启	okd
奥	bod
集	mbg
萱	apgg
练	xai
琴	ggd
仁	wfg
诉	yry
怨	qln
视	oms
撑	rjc
秒	tit
妮	vnx
抖	rwh
货	hmu
针	qfh
演	ipg
护	rot
害	jrf
排	rmx
商	er
混	ija
斤	rtt
铺	qby
腾	exc
狠	vvy
後	hxt
磨	vd
珠	gts
箭	tuw
欧	arq
节	ab
俱	weu
催	wmr
侧	wmj
桑	cos
噢	kbo
渊	ito
乌	qng
拜	mg
帅	jbh
寺	ffy
乡	xte
划	xjh
庆	odi
屠	nfj
赚	mu
融	rmu
盒	wlf
倪	wvq
穆	tki
阶	bwj
隐	bqv
吵	kit
较	lu
渐	ilr
耶	bbh
戒	xak
液	iyw
索	fpx
芳	apr
豪	heuu
竹	ttg
坑	fyn
夺	dfy
薇	ahm
簇	tpc
泡	iql
怔	ngc
鼎	hus
捡	rwq
隔	br
劫	llt
欢	cqw
璇	gpw
胃	lef
巧	awn
帕	bkg
粉	omv
糖	oow
丢	tli
弟	uxr
搬	rex
砍	dqw
肺	eg
抗	ryn
埋	fua
摘	red
铜	qmg
淼	hih
裂	bjy
贴	mvg
顿	bad
友	dc
宏	pdc
斌	cgac
缩	xpw
试	yaa
业	ohh
伦	wwx
棺	spd
板	src
祭	wwm
航	eyn
苗	alf
崔	mrf
惹	atr
乘	tux
聂	bou
闭	uft
横	sa
临	jtk
抵	rsc
摆	rll
宠	pdx
挡	riv
贺	vmu
喔	kna
锦	qkb
骑	cd
洋	iph
颗	jsd
笙	tpg
冥	pju
贼	mxd
京	yiu
疯	unr
予	csj
眸	hcp
牙	rte
赫	fof
祝	okq
价	wwj
版	srcy
扔	ret
盟	jel
幼	xlt
鸣	kqg
股	exy
吓	kgh
奔	dfa
环	ggy
挖	rpn
御	hrcb
壁	daf
橙	swg
麻	vyg
徒	hky
滑	ixg
虫	jhn
劳	apl
蔡	aww
赌	mfj
踢	ljq
枝	sfc
墓	sff
斜	wiw
扇	ond
瘦	uvh
烂	ou
夹	xwi
险	bwq
尖	idu
婉	vpq
蝶	jkd
薰	aqb
浓	ipk
振	rde
设	yxy
恐	ann
潘	iml
添	igd
呵	ksk
唤	kqm
园	lfq
戏	cxy
欠	qw
伴	wvu
镜	qx
赛	pmu
毕	axf
晋	goj
返	rcp
芒	ayb
丑	nfd
攻	aty
鹏	eeq
裴	mxy
耀	knr
哩	kua
谋	yaf
冠	pfq
休	wsy
凶	bty
搭	raw
咦	kgx
插	rqv
盐	fhl
矮	ctv
脑	eyb
踩	les
晒	jsg
咒	xnb
呃	kdl
嫣	vgc
陵	bfm
凑	udw
增	flj
势	hlr
啪	krk
冒	jhf
嘿	kby
症	ugc
荒	ayq
袋	hyy
政	gct
纵	xay
芸	acu
榜	su
益	uul
翼	nl
嫌	vuv
铭	qqk
刮	qjh
禾	ttt
哇	kff
昂	jqb
拧	rps
奖	uqd
质	rfm
卓	hvj
助	elt
敏	xty
缝	xtd
净	uqs
凰	nkg
甘	afd
编	xo
缓	xegc
咳	kao
篇	tom
舟	ett
谓	yle
童	uua
扛	rag
题	jw
功	alt
陶	bqr
酸	scm
残	bgx
亭	hsj
码	dcg
释	mcv
肝	ef
召	vkf
遭	emj
爆	ojr
烦	odm
霜	ftf
探	ros
巍	mtv
息	tni
损	rkm
柏	skg
稍	tie
荡	aiv
晶	jjj
咯	kog
朗	yve
户	ooo
擎	ast
候	whn
傲	wgt
蟒	jad
萌	aje
邱	rgb
霞	frn
井	xgg
劲	ca
忆	nnn
译	yc
挣	rqs
倾	wad
营	apk
犹	vdn
赤	fou
杆	sfh
幻	xnn
崖	mdff
尝	icu
疾	uci
奎	dff
哄	kry
莹	apb
芷	acf
珍	gwe
闲	usi
刑	ejh
钻	qvg
熟	ybv
采	esu
厂	dgt
避	dap
嘭	kfa
姚	viq
讨	yfyy
雁	dwr
芬	amv
拦	ruf
胸	eqb
亏	gwb
涛	iof
炸	okf
核	sao
申	jhk
郎	yvb
执	hgh
坚	tff
票	biu
壮	ufg
怡	nck
识	yku
澈	iyc
朕	esy
拨	rhd
勒	qlt
沫	igs
韵	xqu
例	wbj
炒	oi
柄	sew
消	iie
鼻	tpj
冉	mfd
冻	uai
诚	yp
赏	jmu
突	pdy
岗	mmr
浮	ieb
密	pno
固	ldd
妻	gwv
弘	xcy
迟	nmp
联	bsy
悔	nxy
免	lsv
澄	iwg
丰	dhk
润	iug
臂	dae
鸢	aqg
捧	rdw
枚	sty
狮	vjk
逛	vgp
蹭	llj
鹤	prq
拽	rjx
瓶	ueg
箴	tdr
蛋	wju
谭	ysv
箱	ttf
爪	ohk
孤	boc
葛	ajq
粗	oeg
虹	jag
抚	rfs
晕	jpl
涉	ici
臭	tdy
移	tqy
积	tku
萨	abu
绣	xtet
奶	vet
潮	ik
粘	ovg
页	dmu
载	jld
翌	nuf
肾	tef
备	ofk
涂	iwi
料	owh
健	wwf
束	ugh
灌	iax
献	heuy
农	pki
盼	hmv
专	vcu
映	jmd
彭	fae
喘	kmd
键	qwf
晃	jkb
恋	pni
莎	aiit
拔	rdc
藤	aex
录	jii
眠	hne
财	mft
僵	wgl
钢	qmr
烫	ivo
摩	vch
禅	oul
丙	ewi
困	lsi
雄	dcr
劈	dav
棒	sdw
遮	lop
哑	kgo
昭	jvk
诀	yby
岭	mdy
忧	ndn
征	hgc
弓	xng
懒	nuq
岸	mdfj
蓉	aprf
判	ojh
咚	ktuy
扭	rnf
蹦	lme
互	gxg
踹	lmd
尤	dnv
夸	dgw
撕	rhr
詹	qdm
寨	piu
抄	rit
碧	gkd
艳	dhq
旗	ph
柯	ssk
习	nud
否	gkf
肌	enn
社	ofg
唰	knb
盆	mvl
饿	hry
惟	nrg
奉	dwv
犬	dyi
盏	gxl
弦	xac
私	tcy
豆	gaf
姆	vxs
婚	vsn
昌	jjf
担	rjg
剧	ndj
笨	tjf
咸	drx
确	dqeh
跨	ldg
检	swq
庭	oqp
拥	reh
废	ohd
炼	oai
锅	qkm
鹿	sxv
汇	ian
烨	omx
粥	xox
喻	kww
泉	khi
沾	ivg
衍	hiw
逐	eup
丧	fue
潜	iaa
兼	uvo
搁	ruo
湾	ipx
涨	ixh
尿	nhi
租	teg
桃	siq
港	irl
弃	yca
跃	lmy
丘	rgd
宣	pgj
捏	rjf
眨	htp
产	ute
裙	bvt
优	wdn
库	olk
萍	aif
抿	rne
嗡	kmc
赐	mjq
棍	sja
亡	yyg
膜	esy
曜	jnr
狐	voc
鼓	faf
繁	xtx
妹	vfi
获	avd
茨	aku
瞥	oth
噗	koa
妆	uvg
澜	ius
颇	hcd
触	qejy
庙	ond
桓	sgj
逢	tdh
刃	vyi
裳	jy
肃	vij
姨	vgx
捞	rap
唔	kskg
媚	vnh
宸	pde
仲	wsh
荆	aej
诛	yts
倚	wds
啥	kbkg
逆	ubp
琦	gds
寿	ofy
戎	xde
涵	ibi
躺	yjg
剂	cjjh
煞	qvt
柴	cxs
偶	wjm
洁	ifk
痕	uvi
喷	kfam
佩	wnk
贫	mvm
覃	svj
呗	kmy
祁	obh
缠	xou
创	wlj
寸	fyi
捉	rly
梓	sah
洒	isg
研	deh
桂	sffg
割	jrj
厅	dsk
赞	eqe
隆	btg
沿	ink
示	wmi
洲	iji
窝	pkm
漫	ijl
伏	wdy
咻	kws
钦	qqw
哉	jkd
幸	fuf
惜	naj
枯	sdg
霸	fqe
乖	qux
掏	rqr
乾	ksn
置	lfe
睿	hp
怜	ndy
逗	gap
猴	vw
坟	fcy
梳	syc
咋	kkfg
焦	rou
雯	fcu
冈	mri
继	xon
脏	eof
呐	kmw
葬	abx
赔	muk
充	ycq
僧	wljg
仪	wyr
壳	fpn
导	lfy
眯	hoy
赴	khi
嗅	ktd
剪	uwv
抛	rvl
盯	hsh
覆	sh
织	xku
泼	ihd
淑	imt
拂	rxjh
责	gmu
策	tei
技	rfc
掐	rqvg
匹	aqv
歇	jqw
疑	xcc
颈	cad
填	ffe
校	sur
窜	psk
速	upi
咏	kyi
耍	dmv
揍	rdwd
胆	ejg
距	lan
患	skn
芙	aau
鲜	cph
挽	rls
促	wly
捅	rce
湘	itg
辞	qah
蜜	pnoj
邵	vkb
跪	lqd
烈	bjo
兹	uou
剩	tuxj
叠	cop
娟	vke
颤	ylk
妍	veh
挨	rcc
贱	mgx
婆	ihcv
舔	qgdy
闷	uni
粮	oyv
押	ruh
桐	smg
仓	wlb
掀	rrq
旋	pwi
屏	nue
彦	utee
桶	sce
翎	dyn
麟	sxo
蟹	qev
末	gs
坤	fjh
盈	ecl
腐	owfi
歪	ggc
沟	iqc
蒂	aup
勋	kml
附	bwf
俩	wea
削	iej
蠢	dwjj
馆	hpd
珊	gyg
祸	okm
蛮	pju
掩	rdj
倩	wge
竖	tuf
鑫	bub
烛	ojy
猎	vaj
毁	vax
函	bib
欺	hqwy
磊	ddd
拆	rry
绍	xv
赖	uqm
泛	itp
舌	qtgg
奕	pdu
邀	kpt
旺	jgg
焚	mou
馨	fnh
慌	nay
兆	iqv
参	cde
巷	rlb
瞎	hjr
遥	erm
径	hca
浇	ixp
啃	kce
效	urt
裹	yjs
延	tcp
菊	aqo
漆	isw
彻	ha
砖	dvc
历	dle
炮	oql
揉	rcs
扒	rmy
勤	qfl
燃	oqd
鲍	cql
幕	sbj
碑	drv
披	rhc
妇	vvg
务	tlr
艺	anb
邢	eb
吟	kdn
豹	eqy
憋	otn
株	sts
跺	lns
骆	cog
奏	dwg
腹	etj
芝	apu
妙	vit
批	rax
债	wgm
坠	bwff
邦	obh
肥	ejn
坡	fhc
烤	ofw
蹬	lwg
育	yce
辆	lea
误	ykg
帆	bny
樱	smm
茂	adx
禹	tkm
悟	nsk
惨	ncd
蜀	lqj
锤	qqa
祥	oph
呜	kqn
央	mdi
廖	onw
钉	qsh
签	twq
订	ysh
控	rpsg
崩	mee
埃	fcc
筑	tan
帐	bhs
警	asty
脆	eqd
皱	qvh
赠	mlj
丈	gr
嗨	kcu
宅	pmb
腔	eps
危	qdl
驴	cot
吊	kbj
续	xvi
沃	imy
熙	ayl
餐	hqc
邹	qvb
驻	cbg
旭	vjd
丫	uhk
堵	ffj
攀	mid
仇	wvn
俞	wwj
孩	bao
矛	cny
愚	jmc
撇	roty
胎	eck
卒	yafj
携	rre
叮	ksh
拾	rwg
标	swm
恭	riyu
栋	sai
拐	rvt
贪	dmu
爵	elv
疏	ccy
贷	hym
盗	klf
伐	wxy
屈	nbm
捕	rb
榕	spr
陌	bdj
姑	vdg
蛟	jur
丸	vyi
宴	pjv
预	csd
罩	lhv
蕾	afl
靖	uge
坎	fqw
笛	tnf
仔	wbg
挪	rob
戳	nrxy
肿	esh
韦	vnv
捆	rlsy
限	bvy
鼠	vub
娃	vff
罐	rma
允	cqb
坦	fjg
绳	xkjn
俺	wdj
炉	oot
窄	pkf
铃	qdyy
呛	kwl
狄	voy
遣	xdp
乳	ebn
卧	ayh
栏	suf
钓	qqy
昆	jax
菁	age
诱	yte
饼	hue
肠	evt
斑	gcgg
爽	dii
瓷	kgn
袭	dxy
激	ikp
罚	lyj
猿	vfk
资	kmu
饱	hql
绑	xob
慈	uon
撤	ryc
揽	rjm
淋	imy
翁	mcn
蕊	ani
溅	img
潭	isv
嫂	vvh
泣	iug
穴	pyy
鹅	ryq
盾	rfh
委	tvf
棋	shy
菌	altu
辩	aya
拢	rdx
痴	uck
棉	skb
评	yfu
购	mqc
霖	fmu
晟	jpx
焰	oqv
耗	dic
茜	asf
暂	lrj
憾	ndr
羞	pnf
剥	jij
衰	ygk
铸	qof
培	fuk
链	qlp
串	skd
椅	sds
庞	odx
牢	ppj
雍	yxt
哀	yku
奴	vcy
淘	iqr
税	tdq
缸	rmag
雕	mfk
酷	sek
婵	vul
辣	auy
迈	gqp
截	jrd
摊	rcr
杂	viu
揪	rto
卜	hhy
捷	rgv
岂	mlb
享	ybf
畔	lvu
郡	vtkb
妾	uvf
廷	qpi
朴	shy
塘	fow
监	jlf
趟	kjd
鞭	qwg
拣	rai
筱	twht
济	icj
律	hwf
栽	jsi
弥	xqi
禁	mwm
溢	iuu
介	wjk
壶	fpo
巫	aai
蒸	abi
粒	oug
哗	kmx
楞	slp
熏	qbu
账	mhs
阔	uiq
届	nnd
拎	rdy
衫	bet
昧	jfi
兔	lsy
陷	bqvg
黛	hyb
焱	ooou
衡	hcw
逊	bip
囊	npx
梨	tjs
瓜	oci
勺	qyi
跌	lrw
畏	leu
龚	dxr
柜	san
楠	she
塌	fjn
嫩	vut
悉	mni
档	siv
醋	saj
淌	ijg
瞄	hal
绮	xds
嗤	kbg
殇	btv
苑	aql
璐	glo
佐	wda
郁	efb
俑	wce
漏	inm
革	qgh
仗	wgr
搓	rpa
齿	cbj
帽	bjhg
枕	sps
浸	ivp
翡	mxnf
颖	xtdm
拒	ran
芊	aqj
亩	ylf
琰	goo
瓣	aoc
倦	wxl
撩	rdu
耐	dmf
扁	oma
筋	tel
偿	wic
樊	midu
虾	jgh
遗	xmp
彪	hnee
舜	jbj
茧	aju
茹	avk
况	ukq
鄂	xgw
昔	ajf
誓	rryf
酶	sxy
婴	mmv
氧	epk
叉	cui
阻	beg
垫	hff
毫	hcn
饶	hxp
拟	rnw
统	xyc
蛊	jlf
彬	met
胶	eur
掰	mgm
灏	iki
绘	xoc
昏	snj
炖	oba
馀	hwi
隼	rfj
棱	sfm
赋	mga
溜	iqy
卵	qyty
丛	agf
训	yjh
揭	rjq
玫	gty
磕	dll
嚼	kel
态	dun
瞒	hae
煜	oju
砂	dit
俗	wmrg
堡	mkf
察	pww
搜	rvh
悬	ecn
淳	iyb
钧	qqu
噬	kta
媛	veg
宾	prg
盲	yhf
娅	vgo
络	xog
钙	qgc
议	yyr
协	flm
漂	ibiy
稀	trd
钩	qqc
蝉	jul
诶	ycc
魅	qcf
鳄	cxg
摄	rbo
沁	ini
霆	fqpu
仰	wqb
捂	rsk
翘	xpn
销	qie
誉	cyf
讯	ynf
汁	ifh
仆	why
伪	wlu
琼	gyi
鞠	qqo
职	bku
瑟	ggn
甄	sfgn
堪	fhn
宿	pwd
模	ssy
驱	car
蓬	atdp
斋	cdm
笼	tdx
姿	kvf
煤	oafs
漠	isy
慎	nfe
企	wcf
浆	uqh
趴	lmy
渣	isj
聋	dxb
访	ypt
髓	xda
痰	uoo
渠	ians
湛	ihn
适	qpi
滞	imp
钠	qmw
龄	cbd
瞟	hbi
擒	rwy
脾	erv
午	rhk
叙	wicy
茅	acr
嘘	kho
灾	pou
忌	lni
吨	kba
裘	fyk
帘	pbj
臻	adw
锡	qjq
彤	mye
杖	sgr
戟	kxy
稻	tev
寂	pmt
襄	yxe
幅	brl
泻	ipq
焕	oqm
佑	wtr
箐	tge
谎	yay
嘶	khr
框	sag
魁	qcw
扰	rdn
掷	rsb
搂	rov
杏	skf
侵	wvp
瑛	gam
攒	req
枣	eiu
测	imj
翅	fcn
泄	ikd
竞	ukqb
楷	sax
搏	rbf
宰	paj
楣	snh
疤	ujv
阎	uqv
渴	ijq
缚	xbf
巢	vjs
辽	bpi
梯	sux
厄	dlv
扮	rmv
膏	hke
裤	bol
隋	bda
籍	tdi
龟	qjn
坛	fcy
镶	qyx
币	tbk
兜	qkn
磐	exd
耿	boy
颠	feu
坊	fpt
炽	oku
恼	nyb
旅	pqu
骇	cao
翰	kwn
驰	cmn
序	ocs
绵	xkb
惧	neu
瞅	hto
堕	bef
捶	rqa
裁	jyk
谱	yu
蹿	lps
麽	vog
傀	wqc
聪	bdn
躯	yar
惯	nxf
窑	prm
褪	bvp
窟	pnb
蜂	jtd
蹲	lus
廊	oyvb
搅	rim
鲲	cja
规	ams
呦	kxl
敷	bpty
犸	vcg
辨	ava
嘎	kdh
惑	xkg
授	rjcy
麒	sxh
摁	rld
玥	geg
册	ygd
谨	yqf
琉	gyc
窦	pvi
恰	nw
植	sfe
刁	ngd
潋	iwq
逝	rrp
验	cw
煎	uwo
槐	sqc
瀚	ikw
述	syp
棵	sjs
污	igw
纱	xi
蒲	aibu
铲	qut
鸭	uqg
幢	buu
矿	dot
哒	kdp
喉	kwnc
描	ral
苟	asf
貂	evk
迁	qpi
桦	smx
囚	lwi
稿	thk
谦	yuv
频	cid
浊	ijy
瞬	hjb
扈	okj
俄	wryy
丶	yee
岑	mdb
涩	ivy
炫	oac
睁	hqs
骁	cxp
喽	kov
循	hrf
择	rcv
挫	raf
煌	okg
饥	hnn
骄	cmj
糊	ode
捎	rie
淮	irg
秘	tno
肤	eay
婶	vpj
孰	ybvy
笋	tvt
嘚	khx
朋	eeg
肋	elt
呸	kgg
粟	sou
塑	ube
肆	vwf
抠	rar
泊	ikg
熄	otni
绫	xfm
冀	uxl
棚	see
渗	icd
滩	icr
氨	epv
侠	wxw
芭	ajb
敛	wqt
愣	nlp
膝	esw
斧	mrj
厌	ddy
糟	oem
兑	dqb
虐	hvd
卦	ffh
售	rkf
构	sqcy
典	mri
檀	syl
肚	efg
菱	afm
侍	wff
妄	yvf
挠	rxp
搽	rawi
脂	exj
灶	ofg
碾	dna
嚷	kyx
卸	rcb
坪	ffu
捻	rdni
际	bwm
琥	ghn
迹	ppi
驼	cpx
栗	ssu
滕	exi
漾	iugn
穗	tgj
耕	dix
钾	quh
狱	vyd
辈	mxl
嘟	kfj
寇	pfqc
乍	kfd
蝎	jjq
弑	jaa
谌	yhn
酱	uqsf
夭	myi
孕	ebf
帖	bvg
榻	sjn
灿	omh
燥	okx
舱	ewl
桩	sof
殊	bts
澡	ikx
莽	ady
辱	def
锻	qnx
筒	tmf
缴	xkp
昴	jqt
衔	hqwh
貌	ekq
赦	fot
裕	bmr
倘	wjg
婧	vgeg
癌	ukx
缕	xov
攥	rth
溶	ipr
悠	wht
绞	xur
驾	vcf
储	wyf
炭	mdo
忒	anii
咧	kbjh
柚	sng
栓	sox
茗	aqk
酥	sty
酿	syv
叩	nhn
竭	ujq
芽	art
贬	mtp
锺	qqua
啰	klq
懿	fpg
刨	qlj
喏	kat
骏	ccm
途	wip
伙	woy
嗔	kfe
浦	iby
秉	tvd
勉	lsl
夷	gxw
鹫	yid
傍	wup
啄	keu
浴	imr
肘	efy
蚁	jyr
觅	ems
汀	ish
喵	kal
拱	rry
挟	rxw
督	mtch
腻	eaf
谏	ysl
枭	qsi
趣	kbc
券	xvr
毯	cno
庵	odj
浔	ivf
芦	aor
叁	cdd
窥	pams
艘	evh
凿	ouf
屁	nax
材	sft
蒜	awm
嗖	kvh
窃	pav
豫	csl
轴	lng
谜	yop
铠	qml
仿	wpt
渔	icg
滋	iuo
羚	pdyy
播	rml
脓	epky
饰	htb
屯	bav
摞	rlx
纷	xmv
鳞	cob
嫔	vpr
廉	ouv
晏	jpv
叱	kxn
簿	tib
葱	aqr
迅	nfp
桢	shm
芯	aniu
贯	xfmu
啼	kup
晾	jyi
屎	noi
儒	wfd
堤	fjw
棠	jsu
汽	ien
碳	dmd
腕	epq
锯	qnd
拌	rvu
蜡	jaj
邻	dyb
努	vcl
卑	rvk
磁	duoy
扩	rot
鸦	rtq
坝	fmy
槿	sqf
烙	oog
粪	oru
莞	apf
锈	qte
昨	jkf
魄	kqc
扳	rrc
秃	tnb
匪	amx
虑	hni
阅	udq
弧	xocy
碟	dkd
垒	ccc
蘸	asr
贞	hmu
津	iwf
恃	nff
鉴	jbu
黏	twi
匣	auk
庚	ovw
辟	dah
咪	koy
嗜	kfx
氢	eca
庸	owe
绒	xxd
晖	jplh
巾	bhn
绊	xvu
奋	dlf
衬	bfy
轿	lmj
碱	ddr
臧	uay
迦	vpi
陀	bpx
呔	kdu
啧	kgm
脊	iwe
蕴	axj
蚊	jcy
喀	kpo
毋	xdd
薪	aui
躁	lkx
宪	peq
敖	gty
旦	jgf
牟	cpj
缀	xoo
寡	pdev
胀	ehs
雇	ord
梗	sgjr
缨	xmm
禽	wyb
裸	bjs
俏	wie
檐	sqd
违	vnp
雌	cxr
霉	fxu
橘	scmr
迫	kpi
掘	rnb
筐	tag
荀	aqjf
逮	vip
叼	kng
灼	oqy
槽	sem
淫	ieqg
腺	ekh
贡	amu
凸	gmg
斟	hnw
虏	hle
壹	fpga
杉	set
歉	uvow
辅	lby
阀	uwx
撬	rcn
趋	kqv
匠	ark
抑	rqb
泵	dhi
睨	hvq
驶	ckr
鲸	cyi
悄	nie
俯	wow
拓	rdg
诊	ywe
滨	ipru
苔	ack
蹄	lup
蹙	dmtl
仕	wfg
琢	geu
轨	lvn
乏	tpi
究	pvb
铛	qiv
冤	pls
涧	iuj
澳	ibo
铅	qnk
契	dhv
昼	nmj
纲	xmr
霄	fie
甫	bgh
畜	acl
瘫	ucr
铮	qqs
恕	vkn
捐	rke
朔	ubeg
番	mlf
钝	qba
耻	bcg
役	hxy
砚	dms
锄	qel
佟	wtu
仑	wxb
拈	rvg
慰	nwm
凳	wgan
揣	rmd
氯	eji
涎	itc
舰	emsn
栖	ssg
浑	ipl
骤	cbc
呕	kary
巡	vpi
烁	oqi
枉	sgg
匀	qud
舀	evf
昙	jcu
蚕	gdj
暇	jrn
珩	ghw
署	lfj
孽	atdb
茎	aca
噎	kfp
宵	pie
懵	nal
梧	sskg
沛	igb
茉	ags
噶	kaj
捣	rqm
疗	ubk
篮	tjl
靳	qrh
奸	vfh
舅	vll
胺	epvg
诵	yceh
屑	nied
巳	lngn
洼	iff
玺	qib
醇	syb
絮	vkx
娄	ovf
钵	qjg
颂	mcd
厥	dub
唬	khn
祈	orh
稠	tmfk
奢	dfj
筛	tjk
禄	oji
瘤	uqy
撵	raa
杠	sag
砌	davt
邮	nbh
鞍	qpv
筝	tqs
躬	yxn
吁	kfh
喧	kpg
嬴	yev
斐	mxc
凹	gbg
擅	ryl
洵	iqj
绢	xke
褐	bjq
屡	nov
沼	ivk
磷	dob
廿	aghg
奚	exdu
敦	ybt
旨	xjf
渝	iww
删	ygj
掖	ryw
践	lgx
笺	tgx
诈	ykf
靴	qhn
墩	fyb
佣	weh
滤	ihni
珂	gsk
畅	jhv
劣	itl
杭	syn
粤	tko
膛	ejf
鬓	vep
抡	rwx
驮	cdy
耸	abf
逾	wwp
叽	knn
崇	mpw
诏	yvk
勃	fpb
毓	xych
详	yph
妥	evf
履	nht
弊	ota
怯	nly
援	reg
桨	uqsu
绸	xmf
馅	hqv
嵌	maf
绪	xfj
贰	afmi
硫	dyc
拙	rbm
拴	rox
揖	rkb
胞	eql
苞	aqlb
葵	awg
赎	mvi
墟	fho
棕	spw
纽	xnf
陡	bky
馍	hsy
冢	peu
叛	orc
徽	hmg
皖	kpf
逞	kgp
拘	rsg
硕	ddm
罕	ofj
聘	bnw
蔽	aot
绷	xee
旱	jfj
矢	ctg
咕	kdg
闫	udd
吏	rri
杵	srh
闵	uci
羌	pnv
藉	adi
敝	oty
沧	iwl
犁	tjp
障	bxf
驭	ccy
怂	aniu
捋	ref
梭	scmt
疫	uxi
籽	obg
邑	kjb
啷	kyv
蔓	ajlc
睛	hge
蓄	aac
垢	ffk
瘪	utw
佬	wfx
棘	eie
览	jms
鹜	ctq
阙	uub
估	wdg
匕	xtn
飙	dydr
刹	jjh
浙	irr
荫	abe
踱	llc
斥	ryi
沥	idl
腥	ejp
剖	ukj
磅	dup
仨	wdg
罡	lgc
翟	nrf
掺	rcd
沪	iot
炙	qoi
犀	nip
询	yqj
妒	vot
岔	mvmj
幺	xnny
欸	ccq
痨	uap
糕	ougo
芹	arj
苓	adyu
闸	uuk
媒	vaf
岱	hymj
峻	mcm
瞻	hqd
祺	ohy
蔚	anw
恬	nqg
滢	iap
茵	ald
酯	sxj
戊	dxyi
盅	slf
拭	raag
箍	tra
袜	bgs
峒	mmg
搀	rlsu
蜷	jxl
隙	bij
哨	kie
摧	rmr
熔	opr
窘	pvt
岐	mfc
掂	rok
歼	bqh
铝	qkk
嚎	khe
姝	vts
乞	stg
掸	rul
峡	mxw
暝	jpj
秤	tfu
馋	hls
鸥	arqg
喃	khef
臀	nrxe
遁	rfhp
颊	xwd
倔	wnb
撅	rduw
榆	sww
锥	qrg
鸽	wqgg
侄	wag
弩	vcx
筷	tnbu
纤	xqh
谅	yyi
剃	uxj
厨	dafy
掬	rqo
淹	idj
腌	edj
蛙	jffg
赣	xft
阖	ull
匙	jwx
妞	vnf
姥	vfx
璧	dabu
胥	wef
卯	qtb
屿	mqg
瘸	uvmi
脖	efp
萝	alq
贩	mrc
垮	fdg
簪	tls
址	fcg
娥	vr
瘾	ubq
碘	dmr
腮	eln
捱	rdf
撸	rcjg
炕	oyn
茴	alk
骚	ccu
嗷	kgt
彰	xfe
炀	ovt
黯	bxg
凋	umf
缎	xnx
鞘	qieg
亨	ybj
咔	kmy
愧	nqc
琏	glp
纺	xpt
芮	amw
吱	kfc
绽	xpwy
篱	tyb
闽	uji
俭	wwq
咣	kkn
寝	puv
析	srh
藕	adic
螺	jlx
钗	qcu
狈	vmy
箫	tvi
谬	ynw
酌	sqyy
镀	qlc
氮	eoo
胁	elm
卤	vri
娴	vus
溺	ixu
遵	usfp
糜	voi
暨	vls
荐	adh
伶	wdyy
沏	iavt
瑕	grn
糯	ofd
裔	ykm
陨	bkm
嘱	knt
撼	rdr
伽	wvg
庶	loi
枳	sku
疮	uwl
袄	bmy
靓	gem
旷	jot
筹	tof
纨	xvy
襟	bmw
靡	vmx
涅	ijf
绥	xev
臼	vth
钳	qafg
匾	aom
帛	kbj
竿	tfj
苯	ajf
蟠	jml
颅	hnd
鹃	keq
蚀	hjy
恍	nkn
汐	iqy
蝇	jkj
梵	mnu
疲	uhc
痣	ufn
靶	qjn
韧	vnvy
剜	pqb
宙	pnf
怼	eni
痹	ulp
肢	efc
蹩	otl
獠	vdu
暑	jfjf
甭	gej
贸	qyv
厦	ddh
溯	iub
蕙	agj
恢	ndo
胤	txe
艰	cvy
狭	vxw
辄	lbn
顽	fqd
巩	any
沸	ixj
滇	ife
绰	xhv
缪	xnw
蔺	aur
励	dql
驯	cjh
揩	raxk
羹	ugo
暄	jpgg
歧	cfc
祠	onr
茫	aiy
惭	nlr
玮	gvn
郗	rdb
措	raj
禀	ylkm
耽	bps
腓	emx
寓	pjm
滥	ijlg
苛	ask
茬	adj
萤	apj
顷	admy
嗳	kjdc
妫	vlu
搔	rcu
骅	cmx
侬	wpk
晔	jmx
咎	thkf
疟	uvd
睹	hfj
莘	aaj
镁	qug
敞	jty
旬	qjd
篓	tov
谣	yer
泫	iac
渺	ihi
吒	kmn
讫	ysn
刊	fjh
概	svl
烘	ory
疆	xfg
酬	sji
剁	nsj
咂	kab
瓒	geqm
硒	dsg
碍	dxh
蛆	jeg
趾	lcg
饵	hbg
噔	kwga
剐	kmwj
妓	vfc
崽	mlni
徵	hmgt
沅	ifq
炳	oew
皂	kab
莺	apq
卞	yhu
缇	xjw
蛾	jry
驳	ciy
丞	big
匡	agd
姗	vygg
汾	imv
缅	xdl
蜕	jdq
婢	vrv
锌	qah
括	rqg
涯	idf
玖	gqy
纟	xnng
嗓	kco
尕	eiu
嵩	mhk
憎	nlj
械	sxa
蔷	afu
蚌	jdh
诡	yqd
桔	sfk
跛	lhc
嚓	kpw
樽	sus
濮	iwo
鳖	otc
侨	wmjh
厘	dua
厢	dtd
呲	kcxn
垣	fgj
梢	sie
煲	mko
璟	gki
盔	dol
芜	afs
憨	nbti
掣	ljc
咝	kxx
痢	utj
纣	xfy
轧	lnn
宓	pnou
崭	mlr
惩	hgci
瀑	ijr
饲	hnrg
鹊	ajqg
圭	fff
嫡	ved
怖	ndb
恺	nml
椎	srg
盂	fhlf
郊	urb
隶	vii
撮	rjb
豺	eft
叭	kmy
噪	kkx
堰	faj
涤	iti
珥	gbg
荤	aplj
冽	ubj
匈	qbk
眶	hag
凛	uyl
珀	gkg
甸	qld
艹	aghh
蔫	agc
迭	rwp
殆	bck
涮	inb
瓢	bio
陕	bxw
稼	tpe
综	xpwm
唷	kyc
烹	ybo
瑗	gegc
菀	apql
僻	wdah
吮	kcq
咨	kkf
曳	jxe
歹	bgt
溃	ixm
踪	lpw
辖	ljr
镰	qou
剌	ujh
朽	swn
榨	spk
烬	onm
笃	tcf
蛹	jce
锚	qal
厕	dmj
嘞	kql
豁	jrm
钞	qit
殃	bmd
泳	iyi
苇	avn
荔	all
蒯	aee
讶	yrt
霁	fcj
唑	kaf
徙	hcc
栾	psu
绩	xgm
脐	ecj
钮	qnf
愤	nfa
纬	xvn
凄	ugw
咖	kvg
玻	ghc
稚	trg
苹	afur
嘀	ked
癞	uuq
窍	paw
荻	avo
辫	axa
韬	vne
弋	agn
泌	ino
睦	hfm
矫	cmjh
辜	daj
勘	hnl
哐	kag
哧	kfo
涕	iux
灸	qyo
篷	ttd
诩	yng
锣	qlq
镖	qbi
亓	fjj
侮	wxy
孚	ebf
艮	vng
剔	jqrj
嘲	kke
硝	die
苷	aaf
偎	wle
掳	rhl
纠	xnh
舵	epx
闰	ugd
颁	mvd
吭	kyn
晁	jiq
橱	sda
肛	eag
痘	uga
痞	ugkd
腊	eaj
舆	wfl
酮	smg
雏	qvr
亥	aoi
弛	xmn
矩	can
笠	tuf
讥	ynn
贻	mck
锭	qpw
圃	lbi
幌	bjk
祛	oly
绯	xmxg
蛛	jts
迸	uep
袅	qyk
鄙	kdk
骊	cgy
鸠	vqg
黍	twiu
哆	kqy
圩	ffhh
愫	ngx
捌	rvj
攸	whty
珪	gff
矬	caf
秧	tmd
膈	ermh
蔬	acc
啖	koo
栅	syg
町	lsh
韶	xvk
坂	frc
娱	vkg
愉	nww
绶	xjc
酚	smv
瘀	upw
糠	oowi
仞	wvy
嗟	kpa
庇	oax
淬	iya
瓮	mcg
胰	egx
萎	atv
妨	vpt
昕	jrh
竺	tff
藻	aik
讽	ynry
邙	ybh
邬	qngb
悼	nhv
挎	rdgw
捺	rdwm
槛	sjl
渍	igm
眷	xhf
瞿	hhr
艇	eqpy
觞	qet
髻	vef
曙	jlfj
讳	yvn
酵	sfb
钯	qjn
坯	fgg
撂	rlo
浣	ipf
祀	oln
肽	edu
泓	ixc
础	dbm
铎	qcv
镐	qhk
陋	bew
冕	jlsb
栈	sgx
氰	ege
颓	tnd
乜	nnv
夙	nbi
昱	juf
氟	exjk
潼	iuua
缰	xgl
胚	egg
噫	kxni
尉	nwmy
膳	epu
芥	awj
菸	apw
贮	mpg
阑	usl
喇	kuj
嗑	kll
姊	vtn
晞	jrdb
秆	tfh
菇	avdf
锵	quq
骐	chy
佯	wph
匆	qry
匿	aat
忻	nrh
漱	iuq
讼	ymc
郦	gyb
擂	rfl
晦	jxy
硅	dffg
腋	eyw
葡	aqbu
锹	qto
隅	bjm
咩	kph
屹	msn
巽	llr
枷	svg
胄	nef
莪	ary
蛤	jwg
遛	qyvp
醛	saox
骕	cvi
鳌	gtc
唳	kod
嫉	vuc
昇	jta
琨	gja
癖	uda
眩	hac
谤	yup
辙	lyc
噜	kcj
崎	mds
昵	jnx
柬	sld
荼	awi
觑	hom
酣	saf
黔	bdn
冶	uckg
噙	kwy
毙	axb
癫	ufe
篙	thkf
膀	eupp
蔑	aldy
蜥	jsr
褒	ymk
铐	qfw
啵	kih
洽	iwg
湮	isf
睇	hux
篡	thd
蔻	apfc
谆	yyb
蹈	lev
侃	wkq
卉	faj
泠	idy
硌	dog
筏	twx
糙	oek
蕉	aro
虢	efyn
谐	yax
齉	tpn
嗽	kuq
戋	gxi
柿	svm
渭	ile
瘴	uxf
睫	hgv
釉	mng
颦	cidv
唾	kqa
啐	kya
庐	ooe
恤	ntl
毡	cnvd
獭	vuq
谛	yupb
丕	ggf
喙	kxe
坨	fpxn
阜	tdf
髯	vem
壤	fyx
惰	nda
懈	nqe
拗	rxl
汞	ahi
畦	lff
讹	yhn
霓	fvq
霾	feua
拄	rbg
淇	ihy
熨	nwmo
勐	bll
嗣	kma
寐	puf
狸	vua
礁	dro
禧	ofa
蹊	lex
镯	qlqj
募	slr
叨	kvt
峭	mie
戍	dyx
柒	ias
甙	aafd
穹	pxb
膨	efa
坞	fqn
汲	iey
焊	ojf
辐	lrl
驿	ccv
佘	oiu
侣	wkk
倡	wjj
噌	klj
寅	pgn
抒	rcsh
爰	egd
蓟	acj
豚	eeu
驹	csg
吠	kdy
壕	fhe
嵇	tdn
怠	ckn
撰	rllr
椰	sbb
殴	arx
篆	txeu
邺	obh
垛	fns
帧	bhm
椿	sdwj
衷	vkk
闺	uffd
呱	koc
哽	kgj
嗬	kaw
宦	pay
疹	uwe
箩	tlq
缜	xfeu
诅	yeg
迂	fhp
骡	clx
偕	wax
扼	rdl
箕	thu
蛰	hju
赊	moi
亢	ynb
伺	wnr
侦	whm
幔	bjl
槌	std
殖	bfe
瑁	gjh
翱	kdf
馥	tjtt
彘	xga
戮	nwe
挚	hch
狡	vur
痈	uek
繇	ermi
诞	ytc
赭	fofj
隽	rer
啜	kooy
壑	hpg
怅	nhs
牡	nfg
珏	gby
璋	gxf
粱	ivmo
粹	oya
翩	oman
诣	yxj
诫	yxa
谊	ype
鸾	pqg
夯	dlr
晗	jdk
檬	sap
毗	lax
嗝	krm
圾	fey
婿	vwe
萃	ayaf
蜈	jkg
辑	lkb
镑	qup
俘	web
呷	kuh
囤	lba
寰	plrk
悍	njf
悯	nuc
旌	ppg
樟	sxf
薯	alfj
訾	cxyf
骸	xao
鲤	cua
偈	wjq
嘁	kdm
嘻	kfak
岈	mrt
忿	mvn
恳	vni
惕	njq
歆	xqw
皋	kdfj
茄	avf
赍	fap
镂	qov
闾	ukk
僚	wdu
抻	rjh
梆	sob
萦	apx
哺	kby
垄	dxf
嬿	vau
札	snn
狞	vps
瘟	ujl
窒	paf
耙	dij
膊	ebfy
俐	wtj
嗒	kawg
嗪	kdw
巅	mfe
慨	nvl
椒	smt
炊	oqw
煅	onx
祎	ovn
窖	pek
聿	wfd
藩	aim
颐	ayd
魇	ddyc
埔	fby
沽	idg
釜	mfu
唠	kap
拷	rfw
桅	sqdl
焖	oun
缆	xjm
跷	lxp
踝	ljs
遏	jqwp
岫	mng
巛	vnn
沮	ieg
濑	iuqm
罔	muy
蘅	ahc
鬃	vepm
囝	lbd
愕	nxg
濡	ifd
璞	goa
膘	ebi
谗	yls
俾	wrv
嘣	kme
埂	fgjr
浚	icm
燎	odu
爨	wfm
虬	jnn
衙	hsk
叟	vhc
埠	ftd
墉	fowe
奠	usd
慑	nbo
祷	oof
菩	aukf
吆	kxy
噘	kduw
娣	vux
幡	bml
拚	rca
瑰	gqc
箸	tfjf
醯	sycl
锝	qxh
隘	buul
霎	fuv
墅	uac
攫	rhh
皎	kury
眺	hiq
秽	tmq
蚤	cuj
裱	bgk
谒	yjq
迄	spi
媳	vtni
忱	nps
挲	iit
晤	jsk
杳	sjf
橡	sle
沦	iwx
蕃	aml
佃	wlg
孜	bty
孵	qytb
廓	oyb
涓	ike
牲	npg
芋	afh
薨	alpx
蝗	jkgg
淤	ipw
炬	oan
褶	bnk
垦	vff
昀	jqu
枢	sar
楔	sdh
莓	axu
葆	amk
铬	qog
饺	hur
匝	abk
坳	fxl
垩	gof
妩	vfs
娆	vxp
攘	ryx
曷	jqwn
榴	sqyl
祯	ohm
稽	tdnj
筵	ttc
酉	sghg
韭	mxg
鳍	cfx
佰	wdjg
煽	oon
胯	edg
茱	ats
螭	jyb
阈	uxk
陛	bax
鲧	ctx
仟	wqh
嗦	kfpi
坍	fmyg
戌	dxyi
掇	roo
煨	ole
睢	hrg
碌	dji
秩	trw
羟	pca
肴	reff
蒿	ahk
蝠	jrl
贲	fam
逄	tah
陇	bdx
雹	fql
愠	njl
柠	spsh
栎	sqi
泯	ine
滓	ipa
犊	nvi
盹	hba
磬	fnhd
羯	pjq
羿	naj
胫	ecag
虔	hci
蜇	rrj
钎	qqh
丐	gch
夔	qcl
孑	bnh
溉	ivl
狰	vqs
瓤	yxec
窠	pjs
辊	lja
辗	lna
骰	xxy
俟	wcc
嘬	kjbc
垠	fvy
嬷	vvo
屉	nkd
斫	drh
泗	ilg
睑	hwq
翳	acx
荃	aox
霹	fda
骞	pcf
吝	ckf
嗲	kmq
惶	nkgg
戾	ody
渚	ifj
湄	inh
炜	ovnn
褂	bffh
镍	qts
呻	kjh
拇	rxs
晌	jbk
皿	lhng
矗	fefe
绡	xie
苡	anwu
蹚	ljf
郧	kmb
铂	qkg
噻	kpfg
寥	pnw
峦	pmj
敕	uty
斛	qew
欤	qqwy
涝	iapl
熹	fak
睬	hes
茸	abf
荥	aph
赂	mog
跤	lur
阐	uulf
僖	wfa
唆	kcm
殉	bqj
汨	ijg
贿	mef
跋	ldc
郜	ekb
鲨	iitc
佗	wpx
咙	kdx
垃	fug
惚	nqr
痂	uvd
臊	ekx
苄	ayhu
袂	bby
褥	bde
邛	abh
霈	fig
鸳	qlqg
尬	dnw
尻	nvv
峪	mmrg
曝	jjr
泾	ica
濯	inr
祟	bmwm
祢	oqiy
譬	day
雒	org
鹂	gyq
啾	kto
嚯	kfr
怛	njg
柑	safg
汜	iln
滔	iev
牖	soby
矾	dny
祗	oscy
蛉	jdy
钊	qjh
吖	kuhh
噼	kda
圪	fsn
帚	vpb
氛	emv
洇	ild
烩	ooc
燔	oml
犟	xkjp
璜	gan
紊	cxi
缃	xtg
舫	ept
谯	yro
咿	kwv
嫖	vbi
枧	sms
淀	ipwy
烃	oca
珑	gdx
矜	cdn
禺	jmci
脯	eby
蘑	avdf
虺	pji
谥	yuu
辕	lfk
铻	qsk
闩	ugd
髀	xrv
兀	pgt
厮	dhr
忤	nrhh
掼	rxf
朦	eap
疚	uqyi
稷	tlm
荚	axw
菠	aih
轼	laa
雉	crg
麸	gta
厍	dlk
喆	fkfk
壬	qtgg
晰	jsrh
榭	syf
殁	bxy
汰	iduy
烷	opf
猾	vxg
珈	gvg
瑄	gpg
纫	xvyy
虱	ntj
蛀	jbg
蝴	jdeg
诧	ypm
郃	wbh
颌	wdm
亟	bkcg
唧	kvb
嚣	xdm
弁	caj
彖	xeu
懦	nfdm
挞	rdp
腑	eow
谕	yww
赘	gtm
踊	lce
邈	ekqp
隧	bue
俨	wgo
弈	paj
悸	ntb
汛	inf
漪	ivd
熠	onk
猥	vle
琊	grt
癣	ucp
砺	ddq
簧	tanu
纾	xcs
葫	ade
蹇	plu
酰	seq
颔	dkdm
魍	qcm
夥	jsq
崂	map
擘	dac
暧	jjd
澧	ika
濠	ihe
缔	xup
肇	otw
蟾	jqd
诓	yag
诳	yvg
辇	aal
邸	scb
钺	qax
剿	vjsj
囱	tkt
寞	psu
搪	row
漳	ixf
琐	gim
疝	umk
穰	tyx
螟	jpju
裾	bnd
谄	yqv
陟	bci
勖	jhl
哞	kcp
嗌	kuu
寮	pdui
恣	kni
惮	nul
杓	sqyy
杞	sln
沓	hij
濒	icim
焯	ohv
琅	gyv
畲	oil
癸	wgd
膺	owre
芍	aqy
诲	yxy
鄢	gcqb
钿	qlg
锉	qafg
霏	fmx
靥	ddyf
馈	hxm
咀	keg
孺	bfd
屌	nkb
峥	mqs
慷	now
昶	yin
桡	sxp
氓	yne
溴	itd
澹	iqd
牺	nsg
畸	lds
羔	ugou
羲	ugt
遽	heup
骶	xsc
啤	krv
姻	vld
娑	iitv
昝	thj
漩	ipwy
甥	pgl
糗	otd
萄	aqrm
蔼	ayj
裆	biv
镌	qret
馕	hnp
偃	wajv
吩	kmv
姣	vury
摺	rnk
涣	iqm
涸	ildg
矶	dnn
秣	tgs
绎	xcv
绛	xta
蜗	jkm
诬	yaay
迩	qip
铡	qmj
陂	bhc
鼾	tpf
倌	wpd
娉	vnw
婊	vgk
嫚	vjl
嬉	vfa
撷	rfk
毂	fpl
泅	ilw
炔	oby
煳	odeg
猹	vsj
碴	dsj
碹	dpg
胭	eld
胳	eog
腆	emr
蜒	jtc
锑	quxt
锨	qrq
飒	unry
唿	kqri
嗵	kcep
孬	gvb
悌	nux
椽	sxe
涡	ikm
滟	idh
痉	uca
绅	xjhh
荧	apo
蔗	alo
锰	qbl
龇	cbcx
傕	wpr
咐	kwf
哮	kfb
庾	ovwi
懊	nbod
扉	omxd
擤	rtp
渥	ina
熘	oqyl
獾	vaxr
畴	lof
簸	thh
芩	adb
錾	lrb
鹳	axr
劭	vkl
卅	gjk
啬	ful
彝	xgo
彡	ettt
怵	nsy
捍	rjfh
涟	ilp
滁	ibw
磺	dan
腱	ewf
逍	iep
邕	vkj
馒	hjl
骥	cux
乒	rgt
伎	wfc
吡	kax
彐	vngg
惦	nok
揿	rqq
柘	sdg
柞	skfg
橹	scj
淞	ism
痊	uox
痔	uffy
舷	eac
谚	yut
厶	cny
唏	krd
帜	bkuy
怦	nfu
悖	nfpb
摹	sch
杻	snf
棹	shv
涪	iuk
漉	isx
疵	ucx
罴	llo
荞	amj
莒	akk
蚂	jcg
貉	eog
酪	sog
钥	qeg
铰	qur
阉	udj
飚	nro
徇	hqj
斡	kwwh
椁	sybg
汹	ibh
烯	ordb
牝	nxn
瞩	hnt
砾	dqi
苫	avf
蓼	anwe
衅	tlv
讷	ymw
谍	ykd
赁	wqm
鹭	loq
麓	msx
伫	wpg
奄	djn
嬲	llv
慵	nowe
殓	bwqg
澎	ifa
烽	otdh
砧	dvg
邴	ewb
酆	dhm
馁	hev
髂	xpo
侈	wqy
哙	kocy
嵘	maps
扪	run
擞	rovt
榛	sdwt
秸	tfk
誊	xyf
谴	yxd
踞	lnd
蹋	ljn
倏	whty
啮	kcb
奂	qmd
掴	rlby
炯	omk
焙	ouk
熵	oer
甬	cej
粼	obb
莆	abu
衾	dyk
诮	yie
邰	ckb
锊	qef
馏	hqy
佺	wox
噩	gxx
婕	vgv
殒	bkmy
竣	ucm
聆	bdy
莅	awu
螯	gtj
觚	qeo
豕	eui
踵	lqu
迨	ckp
阚	unb
凵	bnh
崴	mdv
戢	kbx
泮	ivu
獐	vxf
硐	dmg
蜓	jqp
诃	ysk
赃	mof
轸	lwe
辂	log
钜	qan
阕	uwg
阝	bnh
颍	xhi
呤	kdyy
喳	ksj
墀	fnip
彀	fpgx
楫	skbg
樯	sfu
漓	iybc
漕	iem
濞	itph
獒	gtd
瞭	hdu
缄	xdr
耒	dii
肮	eynn
螫	fotj
郢	kgb
骈	cue
髋	xpa
仄	dwi
婼	vat
屐	nhf
忄	nyy
忡	nsh
檄	skp
殄	bwe
沂	irh
淝	iejn
潢	ianu
潦	idui
爻	ieo
疽	ued
皤	kmlg
祐	otr
祜	odg
笄	tej
缶	rmk
翕	wnf
聩	bxm
舐	qsn
蜘	jck
诌	yqvg
跻	lcj
辍	loo
迥	mkp
铵	qpvg
隳	bday
驷	clg
卩	bnh
壅	yxtf
嶙	mob
恁	wqni
憩	qtni
煊	opg
珉	gne
疡	uve
砷	djh
绺	xth
脩	whte
舶	ekg
薅	avdy
谙	yxg
逻	lqp
酐	sfh
酹	sef
镭	qflg
颞	bodm
饷	hbk
骋	cnw
鬲	rmuh
鲫	cvb
倭	wtv
冗	pnb
嚏	kfpw
堑	lrf
宕	pdf
帷	brg
恸	ncl
惫	ofn
挛	pch
杈	scu
渎	ivi
睥	hrv
硼	dee
簌	tuq
肪	ept
脲	enh
腚	epw
蓑	aygk
馊	hvh
兕	gbgq
匚	agn
哔	kaxf
囗	lhng
妯	vng
嵴	miw
擀	rkw
槁	shk
汶	icy
沤	iar
渤	ifp
潞	ilo
猝	vya
盎	mdl
笆	tjb
缭	xdu
羧	pcm
胍	eoc
臾	vwi
蜻	jge
钛	qdu
阪	brc
鲡	cgyy
傣	wdw
卟	khy
唵	kdj
塾	ybvf
廾	agt
忝	gdi
拯	rbi
暹	jrp
曈	juu
氐	sci
浒	iyr
狍	vql
芾	agb
邾	tsb
骛	ctc
骠	cbi
哂	ksg
圳	fjh
峙	mff
悚	nuy
惇	nybg
戗	wlx
搠	rub
楮	sfj
橐	npd
氦	eao
盥	shi
纭	xcy
绦	xti
蓓	awuk
蕨	adu
迳	cap
郏	xwb
醴	ska
锲	qdh
隰	bjoo
鹦	mmvg
亳	hmb
兢	dqd
凫	qnv
啡	kmxg
嘤	kmm
奁	dar
嶷	mxcw
恪	nog
悴	nyaf
殡	bpr
泸	ihnt
浜	irgu
玟	gcy
璩	ghe
瘩	uaw
纂	thdi
绚	xqjg
耷	dbf
荇	ahw
蚜	jrt
邝	obh
铣	qeq
镣	qdui
魈	qcie
鳃	cln
厩	dvl
唁	kyg
嗄	kdht
幂	pjd
徼	hkp
抉	rby
汕	imh
泞	ips
湃	imgf
爇	afmo
狎	vuh
窈	pxl
茁	abm
踮	lok
酝	scy
钡	qmy
饴	hck
佚	wrw
冼	ueq
咆	kqln
哌	krq
垅	fdx
垚	ffff
怆	nwl
戬	gojx
楹	sec
殳	xtny
粑	ojn
粕	okg
羸	yep
肱	edc
诽	ymx
霭	fyj
鞅	qmdy
饯	hgx
鲛	cur
鸯	mdq
佞	wfv
咄	kbm
噤	kmwm
孢	bql
峄	mcvh
烊	oph
牒	skds
珞	gog
琮	gpwm
臃	eyx
虻	jyn
蠕	jfd
豉	gafc
徊	hlk
旻	jcu
歙	wnq
犭	vtnt
瞑	hpj
磋	dpa
肟	egw
腘	elb
腭	exg
蚓	jxh
邂	qevp
铀	qng
镊	qbo
龋	cbt
乓	rgy
坷	fsk
戛	dhx
搡	rco
榉	scv
氵	iyy
汴	iyh
疣	udn
瘆	ucde
缑	xwn
肓	yef
胧	edx
芎	axb
荠	acjj
袒	bjg
袱	bwd
诰	yek
豌	gapl
蹶	ldu
醣	sow
铊	qpx
鬻	xoxh
冮	uag
咭	kfkg
妤	vcs
姒	vnwy
岙	mym
峨	mry
扌	rrr
楸	sto
湍	imd
皑	kmln
睚	hdf
窿	pbt
笪	tjg
羁	lqc
肄	xcw
藐	aek
蝌	jtw
衄	tln
讪	ymh
谞	yweg
铆	qqt
铿	qtf
颀	rdm
颧	axrm
鸷	hqg
麋	sxoi
麝	sxyy
鼬	vun
呓	kan
嘈	kem
囿	lefd
堇	qfd
徘	hmx
扦	rqh
捭	rrv
椭	sbe
楙	mce
猩	vjp
琬	gpq
矽	dqy
筠	tfq
粽	opw
菅	apd
葭	arn
蓦	scf
藁	ahks
蚺	jmf
蜱	jrv
鸵	qgp
麾	vcnv
侗	wmg
弼	xdj
惘	nmu
摒	rnu
氲	ejl
泷	idx
渲	ipgg
溥	ibf
狙	veg
疖	ubk
眚	pgh
纶	xwx
缤	xpr
膦	eob
蓖	atk
螨	jae
蟆	jsy
跽	lln
蹂	lcs
辔	xlx
郓	plb
醚	sop
鏊	gtb
钨	qqn
钭	qwh
阱	bxh
鳜	cdu
佴	wbg
偻	wov
刈	rjh
呋	kay
妪	var
尴	dnj
彷	hpt
枞	say
桉	spv
棣	svi
浥	ikj
猖	vjj
糨	oxk
舂	dwvf
萘	adwm
虓	vhnn
蛔	jlk
蜃	dej
蝰	jdf
跖	ldg
踉	lyv
逵	fmf
酋	usf
酗	sbh
钴	qdg
龛	wdx
厝	dajd
囟	tkr
姹	vpm
宥	peff
屾	mmh
徂	heg
撺	rpsk
汩	ijg
洮	iiq
狩	vpf
琈	geb
砣	dpx
竑	udc
筮	taa
芡	aqw
莳	ajfy
蹴	lyi
轭	ldl
轶	lrwy
辚	lob
镒	quu
阇	ufj
飨	xthy
鸩	psq
僭	wls
哝	kpk
唛	kgty
埚	fkm
屙	nbs
抟	rvc
搴	pchj
柰	swmu
檫	spwm
潍	ixr
炅	jou
炝	owl
琯	gpd
疙	usv
瘘	uov
粲	hqco
缈	xhit
臆	exn
舛	btn
荨	avfy
蕲	aul
褛	bov
躏	lau
迢	vkp
逯	jip
郅	abh
醮	sro
钼	qhg
铙	qxp
铢	qtsy
铪	qwg
骒	cjs
刽	ocj
刿	mqj
卮	flv
媪	vjlg
怄	nar
泱	imdy
浏	icjh
眇	hit
碉	dmfk
禳	oyx
籁	tuqm
缉	xkbg
翦	uwn
赡	mqd
趸	gql
轲	lsk
鍪	ctb
仉	wnn
侥	wxp
俸	wdwv
怙	ndg
悭	ntf
惋	npq
栩	sng
樵	sroy
毖	axn
氤	eldi
滂	iup
疒	uyg
疠	ugq
疴	usk
痪	uqmd
稗	trv
绉	xqv
舸	esk
茇	adc
菏	ais
萸	avw
葶	ahs
谖	yegc
郇	qjb
郯	oob
钹	qdc
骓	crg
鲂	cpt
鲔	cefg
呶	kvc
啭	klv
娩	vlsn
媾	vemf
憔	nroy
挹	rkj
摈	rpr
柙	suh
洎	itg
爿	unh
珽	gqpy
笏	tqr
纡	xfh
缱	xxdp
衮	ucku
袢	bvu
赕	moo
镬	qar
雎	erg
哕	kmqy
啉	kmy
啶	kpwy
囡	lvd
埙	fkmy
奭	ddj
娼	vjjg
彧	akg
挈	dhvh
楂	ssj
榔	syvb
橇	scn
氖	eee
湓	imvl
畿	xxx
瘗	uxw
糸	xiu
臑	efd
芈	ghh
藓	acp
蛄	jdg
谩	yjl
蹉	lpa
遐	rnc
釐	fit
銮	pbuf
靛	gep
颉	fkd
鲈	chn
鳗	cjl
鼐	ehu
兖	ucq
喟	kleg
堃	ppf
忖	nfy
恽	npl
愆	hiwi
揄	rww
槎	spa
槲	sqe
氅	jtcn
洙	its
淄	ivlg
淆	ire
湫	itoy
煦	jso
猬	vleg
琶	ggj
痿	utv
瘁	uya
耦	dijc
胝	esc
舳	eng
荪	abiu
薤	abmg
蚩	bgj
诠	yox
谀	yvw
谪	yed
蹑	lbo
锴	qaxk
霰	faet
颚	xgwm
鳝	cpu
佼	wur
呒	kfs
哏	kvy
圻	frh
媲	vtkx
嬛	vlr
庖	oqlv
忏	nqh
擢	rnr
柩	saq
桠	sgo
桧	soc
椴	snx
榄	sjm
橄	snb
殚	bul
潺	inbb
牍	sviw
琤	gqs
瑙	gvt
璘	gob
疥	uwj
疱	uql
硷	dwq
罄	fnhm
罹	lnr
膻	eyl
蓁	adwt
诘	yfk
谡	ylm
趿	ley
躇	laf
鄞	qfb
铋	qno
雩	fgw
飕	nrv
骖	ccd
丿	too
亘	gjg
儡	wll
吽	kph
圜	llrk
埕	fkg
婳	vgl
挝	rfy
檩	sylm
淦	ibu
珐	gly
瓯	arg
甾	vlf
皈	krc
盍	llf
绔	xdg
缮	xpu
耘	dicy
聒	bqg
荟	aocu
蜚	mxj
蝙	jom
蠡	xeuj
豸	ety
邯	afb
铨	qox
雠	ryr
麴	stq
咛	kps
囷	lti
垭	fgo
墒	fer
岬	muh
弭	xbg
惺	njp
枋	spt
栊	sdx
煺	ovp
瓘	gax
瘕	urn
祚	okfg
箔	tik
肼	exh
蒌	aov
蕈	asv
蚝	jcn
訇	qyd
谧	yno
钒	qny
锆	qek
镗	qjf
阡	bqh
骺	xfkg
鬟	vel
鹬	cmr
龈	cbv
丨	hee
乂	rty
佥	wqf
俦	wof
嘏	drn
嘹	kdui
圉	lfu
妁	vqy
崆	mps
怫	nxj
恙	ugn
搦	rxu
柝	sry
泺	iqi
滦	ipsy
璀	gmr
畀	lpj
睐	hxi
砥	dsc
碓	drg
缗	xne
蠹	npdj
衩	bcu
褫	brh
诎	ybm
郴	mbh
锟	qja
馔	hll
鹄	ekqg
龠	wxk
亍	wgg
刖	wtn
叻	klt
喋	kkd
喑	kxg
坻	fsc
妧	vfq
婺	ctvf
嫦	vjb
寤	pus
屦	nho
帏	bvn
廋	ovh
惬	naxw
扽	rba
揆	rwgd
昉	jpt
杌	spn
椋	syiy
殛	bbk
淖	ihv
焐	osk
玷	gvg
畈	lrc
皙	srk
秕	tax
笞	tck
篾	tld
缦	xjl
胩	emy
芪	asn
菽	amt
蕤	aeu
螓	jdw
诒	yck
诤	yqs
谶	yaxg
蹼	loa
郤	mrb
醺	sqb
阗	ufeu
隹	rthg
髦	vec
鲑	cff
鹉	gac
亵	yhk
伉	wyn
侩	woc
偌	wat
傈	wss
僮	wuu
卬	qbh
坼	fry
孱	nbb
嶂	mxf
徨	hkgg
愍	net
榖	fpgx
榷	sprg
殍	beb
氽	whi
汔	isn
洌	ibj
玑	gnn
玳	ghyy
睽	hwgd
瞠	hjf
碛	dgm
糅	ocsy
缟	xhk
缢	xuu
萁	ahu
讴	yary
赧	foi
跄	lwl
郄	rdcb
骷	xdg
髭	vecx
魃	qcd
麹	gtq
佻	wiq
剋	dqj
夬	bng
娈	pvf
婀	vbs
孓	byi
岖	mar
巯	cay
帻	bgm
恫	nmg
憬	nki
杼	scs
栀	sfl
椐	snd
潸	ime
烝	bigo
瑚	gde
璨	ghq
瓠	dgwc
甑	ljg
皴	cmt
糈	oweg
縻	vxi
耆	fxj
苴	aef
褴	bjlg
謇	pyf
豢	xeuu
锗	qfj
闿	uml
雳	fdl
鼋	fqk
齁	tps
伧	wwl
劾	aol
咤	kpm
囔	knp
垟	fph
婪	mvf
怍	nkf
惆	nmf
憧	nuu
槊	ubes
毳	cnc
汆	tyh
溲	ivh
焗	ons
甍	alpn
瞀	cth
砗	dlh
硪	dry
碣	djq
粳	ogj
腧	eww
芑	alb
衢	hhhw
裟	iitk
襦	bfdm
詈	lyf
诟	yfkg
跗	lwf
踅	rrl
邽	ffb
郿	nhhb
锢	qldg
陉	bca
隗	bqc
韫	vnj
颢	kid
鲇	cvg
鳎	cjn
伢	wrt
俎	ieg
倨	wnd
傩	wcr
咫	nmk
圹	fot
垆	fhnt
妲	vjg
孪	pbf
崧	msm
帙	brw
掮	roe
曛	jqby
枰	sfut
沣	idhh
沱	ipxn
洱	ibg
溏	iow
猸	vnhh
琵	gga
疋	wnh
瘿	umm
皦	kkp
睾	tlf
砒	dax
砼	dwa
秫	tsy
绌	xbm
罅	rmh
耨	did
耪	diu
膂	pque
芫	afq
萼	axg
葺	akb
螳	jjfg
蠃	yej
迤	tmp
遘	emf
铤	qqp
隍	bkgg
飓	nre
骧	cyx
髡	vepb
鬣	vev
鲥	cjfy
鹍	jaxg
仝	waf
仵	wrh
佤	wgn
刍	qvf
呣	kxs
哓	kxp
嗥	kkdf
垸	fpf
埸	fjq
堙	fsf
塬	fdk
妗	vdn
姘	vue
徕	hxiy
忪	nmc
恚	ffn
恻	nmjh
抨	rfu
栉	sab
棂	svo
樗	sfgw
橛	sdu
欹	dskw
氙	emk
洄	ilk
浍	ioc
溟	ipj
澶	iyl
煸	oom
瑬	iycb
癃	ubt
笤	tvk
笮	tkf
篑	txm
籴	tyo
糁	ocd
绁	xkd
缥	xbi
罂	mmrm
脍	eocy
薁	abo
蚪	jwh
蚯	jrg
蛩	anj
蠲	uulj
衤	byn
谂	ydn
遨	gtp
钏	qjh
钤	qdn
铧	qmx
锏	quj
镫	qwga
髌	xpru
麂	sxn
麈	sxb
倬	whv
匐	qrl
匮	axm
囹	ldy
埒	fefy
堞	fkds
妊	vqg
尢	dnv
峁	mqt
峋	mqjg
峣	mxp
峤	mmj
彗	dhdv
恹	nddy
恿	cen
戕	uxy
旖	pds
杲	jsu
楗	swf
滏	imf
焘	ofyo
狁	vcq
猗	vds
痤	uaf
礻	oyny
笳	tvf
篦	ttk
絜	dhvi
纮	xdc
绐	xck
羝	psc
茯	awd
荸	afp
蚣	jmcy
蛎	jdqt
螃	jup
蟋	jmn
讣	yhy
谰	yus
豳	eum
轵	lku
迮	kfpi
郐	ocb
酽	sgod
醢	str
锶	qlni
陬	bbc
韪	jwv
颏	aod
餍	ddyh
馗	vqd
鸱	scq
鹘	xqg
黜	bbm
侔	wcp
儆	was
刬	gxj
呙	kmwu
喾	iek
嗐	kjr
嗫	kboy
囵	lwxv
垧	fbk
塄	flp
娠	vde
娲	vkm
幛	bxfh
庑	ofs
庠	opk
惔	noo
愔	nxg
掾	rxe
揸	rsj
搐	racl
桁	shw
榫	srf
沆	iyn
洧	iefg
淅	isr
濉	ihr
灞	ifqe
珦	gbk
畋	lty
痧	uii
痫	uus
窨	pxf
箓	tji
簋	tvl
籼	omh
缯	xlj
羕	ugy
胠	ely
腠	edw
莜	awh
菡	abib
葩	akj
蒐	aqc
薮	aovt
藜	atq
觐	qfm
诋	ysc
踌	lofy
遑	kgpi
邃	pue
邠	mvb
鄣	xfb
鲢	clp
龌	cbn
俪	wgy
倮	wjs
傥	wjqn
儋	wqd
匏	dgwl
叵	akd
嚅	kfdm
圬	fgwn
堀	fnb
奓	dqu
孛	fpbf
岘	mms
崾	msv
怏	nmd
恂	nqj
憷	nmw
旃	pmy
旄	pcn
旆	pgb
旮	vjf
旸	jvt
栝	sqg
氾	iln
涿	ieu
溘	ill
炷	obg
燧	oue
牦	ncnn
玡	grtt
珲	gpl
瘠	uiw
瞰	hnb
瞽	fafh
矸	dfh
箧	taxw
篁	tkg
绲	xja
缙	xgoj
翙	mqn
耋	fxa
苕	avkf
苻	awf
茝	aay
薹	afk
藿	afr
蚰	jng
衽	bqg
趱	keqm
酊	ssh
醌	sjax
鎏	iycu
铉	qac
铍	qhc
锂	qua
锃	qkgg
阂	uao
阄	uqj
阒	uhd
陲	bqa
颛	mdm
餮	bweh
馄	hja
驽	vcc
鬯	robx
鲮	cfm
鹗	xgwg
黝	bxl
亻	wth
喱	kdua
嘡	kjf
圮	fln
坜	fdlt
埝	fdn
埭	fvi
堋	fee
嵬	mqcu
廪	oyl
悻	nfuf
懋	mcni
拊	rwf
朐	esg
枥	sdl
槠	syfj
檗	das
沔	igc
浃	ixw
湜	ijw
瀣	ihq
犇	pnp
狃	vnfg
瑱	gfe
瘛	udh
瞋	hfe
矍	hhrc
砻	dxd
碲	dupb
磙	duc
窸	pmn
笈	tey
綦	hxiu
绂	xdcy
缲	xkx
耄	fxc
苎	apgf
茆	aqt
茔	apff
茕	apn
荑	agx
蓍	afx
蘖	atds
蜩	jmfk
蜮	jxk
螂	jyv
衿	bdn
裉	bvy
讵	yan
貔	etk
貘	esy
赉	xim
赓	ovwm
跂	lfc
蹁	lom
遒	usp
邳	ggb
钣	qrc
铱	qyky
鞑	qdp
飔	nrl
饬	htl
骼	xog
鬏	veto
鹈	uxq
僦	wyi
凇	usm
刎	qrj
刳	dgwj
哚	kns
喹	kdff
嚄	karc
嚚	xayx
坭	fnx
埘	fjf
埵	fqa
姤	vfkg
嫒	vjdc
孥	vcb
尥	dnq
屣	nhc
岌	mey
崀	myv
崃	mxi
廛	oua
彳	htt
徉	hph
惴	nmdm
挢	rmj
曌	jep
曩	jyx
枸	ssg
栌	shn
桎	sag
椟	sviw
浞	ily
渌	ijiy
湟	ikgg
濂	iou
焓	odk
犰	vvn
玎	gsh
甓	dag
痱	umx
瘐	uvw
瘳	unw
眦	hcx
穑	tfuk
竽	tfhj
箅	tlp
箨	trc
簟	tsv
绀	xaf
缒	xtdp
缬	xfkm
耜	didg
脘	epf
舻	ehnt
芘	aax
芟	axu
茏	adxb
菟	als
蟥	jan
谔	yxgw
赅	mao
跎	lpx
逑	fpi
逦	gyp
遄	mdmp
鄄	sfbh
镉	qrm
阍	usn
鞣	qcs
髁	xjs
鲠	cgj
鲦	cti
侑	wefg
剡	ooj
厣	ddyu
圄	lskd
坩	fafg
墁	fjl
孀	vft
岿	mjv
幄	bna
忑	ghni
怃	nfs
怿	ncv
恝	dhvi
悝	nua
攮	rnp
斓	cus
杷	sjn
柽	scfg
桷	sqeh
槟	spru
橦	suu
沌	iba
涘	icc
滘	ioa
澥	iqe
濩	iarc
燠	obo
燮	oyo
犒	nhk
玢	gmv
珙	gry
珺	gvtk
瘅	uulf
盱	hfh
睃	hcm
砀	dvt
碇	dpw
祆	ogd
稣	cty
篝	tem
罟	ldf
羼	npp
翮	rmun
芗	axt
芰	afc
苋	amsb
苒	amf
蔟	apc
薏	axni
虿	gqj
蚋	jmw
蜿	jpq
衲	bmwy
袪	bly
觏	emfs
觳	fpgx
谟	ysy
谲	ycm
赈	mde
醐	sde
钽	qjgg
镙	qlx
阽	bvg
飏	nrve
骉	cccf
鹑	ybq
齑	cjm
伛	war
佝	wsg
俚	wua
刂	jhh
呖	kdlt
啕	kqrm
坶	fxs
垓	fao
垕	fkfd
垤	fag
埯	fdj
埴	ffeg
奘	ufd
娓	vnc
宄	pvb
屃	nmi
屮	bnhh
岷	mne
崛	mnb
忮	nfc
懑	iaei
撄	rmm
擐	rlr
桕	svg
棰	sqa
楝	ssl
氘	ejk
湣	inej
滗	itcn
潏	icmr
潴	ivfj
澂	imgt
燚	oooo
猕	vxq
猷	usdy
甯	pnie
疔	usk
痍	ugx
瘥	upa
眄	hgch
砜	dnr
砭	dtp
碶	ddhd
礴	dai
祉	ocg
稞	tjsy
绻	xxl
耩	dief
肜	eet
胛	euh
腈	egeg
腼	edl
苜	ahf
茚	asb
莠	ate
菖	ajj
蘼	avm
觇	vms
谇	yya
跚	lyg
躔	louf
郈	fkb
郸	ulf
鄹	bcwb
酤	sdg
酾	sgyy
锷	qxg
镪	qxk
镲	qpwm
闳	udci
闶	uyn
闼	udp
阏	upwu
陔	baoy
隈	ble
饕	kwh
饫	hmy
饹	hog
馑	hqf
驺	cqv
鹆	mrqg
丌	pgth
俳	wmx
剽	bijh
劓	tpjh
唢	kim
啁	kmf
嗉	kgxi
圊	lge
圯	fln
坌	mvff
堠	fwn
塍	exf
墘	fks
嫱	vfu
嬖	davf
孖	bbg
尨	dne
岢	msk
岵	mdg
帔	bhcy
忉	nvt
忐	hniu
忳	nba
悒	nkj
悫	fpni
悱	nmx
愀	nto
愎	ntjt
慊	nuv
戆	xfti
扞	rfh
拮	rfkg
掊	ruk
攵	ttgy
晡	jby
晢	rrjf
朊	efq
枘	smw
柢	ssc
榀	skx
樾	skay
殂	beg
殪	bfp
氚	ejk
氡	etu
氩	ego
沚	icg
涔	imdn
淙	ipwm
溱	idw
漯	ilx
瀛	iye
烀	otu
牯	ndg
猢	vdeg
瞌	hllg
祇	osn
祧	oiq
箦	tgm
簏	tsx
纥	xsn
纰	xax
缧	xlxi
耧	dio
胂	ejhh
膑	epr
臬	tsu
舄	vqo
舢	emh
芼	acn
茭	auru
荜	aaxf
蛭	jag
螅	jtn
裨	brv
褙	bux
襞	dayk
觎	wwms
谑	yhv
谝	yom
蹯	lml
轳	lhnt
逭	pdp
邋	vkr
邗	fbh
邶	uxb
醍	sjw
鋈	imyu
钍	qfg
钐	qet
钚	qgy
铄	qqi
铯	qqj
飧	qhy
骜	gtcf
鲚	ccj
鲵	cvq
鲷	cmf
鳅	cto
侉	wdgw
僳	wso
劁	roj
叆	cjd
吣	kniy
咺	kgjg
啫	kfjg
囫	lqr
坫	fvg
垌	fmg
垴	fybh
夼	djj
媸	vbg
嫠	fitv
屺	mln
崮	mld
巉	mla
帑	vcbj
忭	nyh
怩	nnx
惛	nsn
愦	nxm
憺	nqd
扃	omkd
掎	rds
搛	ruvo
敫	kpty
旒	pyc
旰	jfh
枨	shs
桴	seb
榧	sam
槃	exs
沭	isyy
浈	ihm
溆	iwic
溷	ileu
炻	odg
犄	nds
犷	vot
狷	vkeg
玠	gwj
甦	gjr
畛	lwet
痼	uld
瘢	uex
癍	ugcg
皛	kkk
砉	dhdf
碜	dcd
磴	dwga
祕	ono
笫	ttn
笱	tsf
箝	traf
粜	bmo
缣	xuv
腙	epwm
艄	eieg
茑	aqgf
荏	awq
莿	aei
葑	aff
蒽	aldi
蓿	apwj
薜	ada
蚬	jmsn
蝮	jtj
蝻	jhe
襕	bus
觜	cxq
觥	qekn
讦	yfh
诂	ydg
诔	ydi
诙	ydo
诨	ypl
貊	edjg
赟	cgam
趄	ked
踣	luk
踺	lwfp
辘	lsx
逡	cmtp
遴	obp
酞	sduy
钋	qhy
钲	qgcg
铩	qjy
镏	qqyl
镢	qduw
阋	uvq
鞫	qqyg
飐	nrvd
骟	con
髹	vew
鬈	vex
鱿	cdnn
鲅	cdc
鸮	kwq
鹕	deq
黠	bfk
黥	byiy
黻	ood
亸	ybu
仂	wlt
仃	wsh
佶	wfk
佾	wme
侪	wcj
俙	wrd
冂	mhn
凼	hib
劬	slt
卣	vnd
咥	kag
咴	kdo
哜	kcjh
哿	vsk
嗞	kuo
垡	wxf
垱	fiv
埏	ftc
堍	fls
塆	fpxn
墼	lbx
娌	vuag
婠	vpd
嫫	vsy
孳	uob
嵋	mnh
嵝	mov
帼	blb
庀	oxv
庥	ows
廆	oqc
廙	olr
忾	nen
悃	nls
戡	hnx
戽	owk
搋	rrhn
旎	pnx
晷	jthk
暾	jybt
枇	saxn
桤	sml
梃	sqp
梏	sekg
榈	suk
橼	sxx
歃	qvq
毽	cnwp
氪	edqv
汊	icuy
汭	imw
沩	ilu
泖	iqt
洹	igj
涑	iuy
涠	ilv
湎	idlf
澍	ifay
瀍	iouf
烜	ogjg
焜	oja
犍	nwf
狒	vxj
珰	giv
疳	uafd
癜	unrx
砩	dxj
磔	dbs
秭	ttnt
稔	tdni
竦	uuy
筌	tox
箪	tul
篪	trh
粞	osg
绗	xhw
缁	xvl
缵	xeq
罽	ldo
罾	lljf
耵	bsh
脒	eoy
腴	evw
臌	efac
芏	aff
芨	aey
苁	aau
苣	aan
茛	avu
菘	asm
菰	aboc
菹	aie
萜	abv
蔌	auq
蚧	jwj
蝈	jlb
蟑	jxf
褓	bmk
赜	aygm
趺	lay
踟	lck
轫	lvy
轱	ldg
逅	fkp
逋	bpi
遢	jnp
钕	qvg
铟	qldy
铳	qyc
锛	qdf
锞	qjs
锱	qvl
镞	qpc
靼	qjgg
顼	gdm
颡	cosm
饨	hban
馘	qxkg
驸	cwf
骃	cld
骢	ctk
髅	xovg
魑	qcy
鲞	xcf
鳇	ckg
鳔	cbiy
鸨	xfq
鹞	ermg
麇	sxt
黼	ooby
鼍	xlr
龅	cbq
乇	mtg
乩	vnn
仫	wog
俶	wmt
倓	woo
倥	wps
偭	wdl
傧	wpru
冁	ulfe
刭	cajh
匍	qbi
匦	alv
吲	kxh
唣	kka
啻	upb
喁	kjm
喈	kaxk
噱	kheu
垲	fml
埤	frv
塥	frm
妣	vaxn
姱	vdgw
媵	exv
嬗	vyl
岣	msg
崌	mnd
崦	mdj
嵊	mtu
嵛	mww
庋	ofc
庹	lnm
弶	xyi
徭	her
戥	jpgx
拤	rmy
掭	rgdy
揎	rpg
揶	rbb
敉	oty
斝	xpwj
昃	jdwu
棼	mmvr
榇	sui
槭	sdm
樘	sjfg
欷	rdbw
欻	ooq
涴	ipql
犴	vfh
猃	vwq
璎	gmm
瓴	dyg
畎	ldyy
畚	cdl
畤	lffy
畹	lpq
痖	ugod
瘙	ucu
癔	uxn
眢	qlh
砝	dly
砬	dug
礞	dapu
稹	tfe
笥	tnr
籀	trq
糌	othj
罱	lhe
聃	bmf
胗	ewe
胴	emg
艽	avb
芴	aqrr
苌	ahsu
茈	acxb
茌	awff
荬	aciw
莼	axba
葳	adv
蒡	aupp
蓐	adey
蓠	aybc
蘩	axti
蠋	jlq
袈	vyk
袼	bog
褰	pyk
襻	bmi
诜	yeq
诹	ybc
诿	ytv
谘	ykk
谮	ylsj
谿	exdr
貅	ews
贳	kdmu
贽	hmu
赳	knhk
躅	llq
辏	ldw
辶	pyn
辿	mpi
迓	rtpi
逖	vop
鄯	purb
醪	snw
钔	qun
钘	qeh
铖	qpxy
锔	qns
锸	qqv
镕	qpr
镳	qsx
霪	fieq
鞒	qmjh
鞯	qad
颙	jmcm
饧	hvt
饩	hen
饪	hqg
馐	hpn
鲋	cwfy
鲟	cvf
鲣	ctf
鲽	ckd
鳏	cli
鸹	qqg
鹌	djng
鼙	fafv
鼹	vuj
丬	uygh
乸	mxs
伥	whsy
侁	weq
侏	wts
偲	wln
勰	llli
卺	bigl
厾	nli
唝	kam
唪	kdwv
唼	kuv
嘌	kbi
噍	kro
嚆	kah
嚭	fakk
垯	fdp
垺	feb
埗	fci
埽	fvp
堼	ffff
堾	fdw
墦	fmlg
夤	qpg
妭	vdc
姞	vfkg
岍	meh
岜	mjb
岽	mai
嵚	mqq
庳	orv
廨	oqe
徜	hjg
怊	nvk
抔	rgy
撖	rnbt
撙	rus
擗	rda
昫	jsg
椤	slq
楦	spg
檠	asts
浯	iskg
溧	iss
溻	ijn
澼	ida
燹	eue
狺	vyg
猁	vtj
猊	vvq
獍	vxqn
獗	vduw
珝	gng
琚	gnd
疸	ujg
癀	uan
癯	uhh
眭	hffg
瞢	alph
砑	drt
砠	deg
砦	cxd
碚	duk
禊	odh
穸	pqu
窳	poc
笕	tms
箬	tat
糍	ouo
绨	xuxt
缛	xdey
翚	nplj
翥	fjnf
肫	eba
胨	eai
胱	ekn
胼	eueh
舁	vaj
艋	ebl
艚	eem
艿	aer
荩	anm
莨	ayv
萏	aqvf
蒴	aub
蓥	apbu
蔸	aqkq
蕖	aia
蜣	jpn
蜴	jjqr
裛	yjk
觊	mlm
觋	aam
讧	yag
豇	gaa
豨	eurb
赝	dwrm
趔	kbjk
躐	lvk
躜	leq
躞	loy
逶	tvp
邡	pbh
郫	rvb
鄱	mlbh
酎	sfy
酢	skfg
钫	qpt
钬	qoy
铒	qbg
铗	qxw
锇	qryy
镛	qow
阆	uyv
顸	fdmy
鲭	cge
鲶	cdni
鳕	cfv
鳙	cow
黩	bvi
黹	oou
黾	kjn
亶	ylkg
偬	wqr
冱	ugxg
劐	arc
嗾	kpc
塱	yvef
墚	fivs
嫘	vlx
嫜	vxfh
嵯	mpa
幞	boa
慝	aati
懔	nyl
拶	rvq
捯	rajh
捽	rya
揞	rxg
揠	rajv
摅	rhn
摭	rloy
攉	rfr
攴	hcu
昳	jrw
暅	jngg
杩	scg
柁	spx
椆	smf
椓	seu
槔	skdf
槚	ssm
檎	swy
氕	ete
洫	itlg
洳	ivkg
洸	ikn
浼	ils
涞	ixi
渑	ikjn
湔	iuw
溽	idey
滹	iht
漤	imvg
潆	iapi
炱	cko
狨	vxd
狯	vocy
狲	vbiy
猱	vcsy
獬	vqe
珧	giq
疰	ubd
痦	uskd
瘵	uww
瘼	usi
砹	dary
硖	dxw
硗	dxp
磡	dhn
礅	dybt
稂	tyv
稌	twiy
窬	pwwj
筇	tab
箜	tpsf
篌	twn
篥	tss
簖	tonr
簰	tsr
綮	otx
纩	xot
纻	xpg
绠	xgj
缫	xvj
聱	gtbf
胪	ehnt
腨	emd
腩	ehe
艴	xjq
芤	abn
苤	agg
荦	app
莸	avdn
菝	ard
萑	arf
葚	ahn
蒎	air
蒹	auv
蒺	auc
蕺	akby
蘧	ahe
虮	jnn
蚍	jaxn
蚱	jkfg
蚴	jxlt
蚶	jaf
蛏	jcf
蛐	jka
蛞	jqg
蛸	jie
蜊	jtjh
蜍	jwi
蝼	jov
螈	jdki
蠊	jouo
袤	ycku
裒	yvku
褡	baw
觌	viw
觯	qeu
讠	yyn
谠	yjqn
谵	yqdy
赀	cxm
跶	ldp
跹	lqpy
蹒	lae
迕	rhp
邨	bab
鄅	tkmb
鄠	fgwb
酩	sqk
醭	soa
鏖	sxbu
钅	qtgn
钌	qbh
钪	qyn
钶	qskg
铫	qiq
铷	qvk
锒	qyvy
锕	qbs
锼	qvhc
闱	uvn
阊	ujj
阼	bkfg
陧	bjf
陴	brvh
馇	hsjg
骝	cqy
鲎	icf
鲻	cvl
鳊	coma
鸪	dqg
鹁	fpbg
鼯	vusk
龊	cbl
伲	wnx
倜	wmf
僰	eiew
儇	wlr
冖	pyn
劂	dubj
劢	gqlt
哢	kga
啴	kul
喤	kkg
嗍	kub
嘧	kpn
坒	axff
垈	hyf
垍	ftg
垞	fpm
堉	fyc
墈	fhnl
夂	ttny
奡	dhdj
妘	vcy
媭	edm
宀	pyyn
峃	imj
崞	myb
嵫	muo
嶝	mwg
帨	bdq
廒	ogt
弪	xca
忸	nnf
恧	dmn
悛	ncm
惝	njg
捃	rvtk
捩	rod
掞	rooy
揲	rkd
搿	mgw
摽	rbiy
旐	piq
旯	jvb
杪	sit
栳	sfx
桄	skn
椠	lrs
榱	sygk
樨	snip
橥	vfjs
毵	cden
氍	hhrn
汧	ieh
泔	iaf
泜	isc
洚	ita
洨	iur
洺	iqk
淠	ilph
渫	ikds
潲	itie
潵	iaet
澌	ihrh
瀹	iwxa
炆	ocy
燊	ooos
爝	oel
牮	hyp
牾	nskg
犋	neuy
猓	vjsy
猞	vbk
猡	vlq
獯	vqb
玚	gvt
玭	gaxn
珵	gkgg
琇	gte
瑢	gpr
璁	gtk
璠	gml
璺	wfmb
疃	luu
瘃	ueuy
瘊	uwnc
眈	hps
瞍	hvhc
磲	dia
祓	odc
祼	ojs
禋	osf
禘	oup
窣	pya
糇	own
絷	hxiu
缍	xqa
缳	xlrk
罘	lgu
耥	dijg
耱	div
胬	vcm
臁	eou
舣	eyr
舨	erc
舴	ekfg
芣	agu
苈	adl
茀	axjj
茺	ayc
茼	amf
莩	aeb
菔	aeiu
菪	apdf
萋	agw
蒇	admy
蒉	axmu
蓊	amc
蔹	awqt
蕞	ajbc
蜉	jeb
蜢	jbl
蝽	jdwj
螽	tujj
蟀	jac
蟊	cjju
裢	blp
裥	buj
诐	yhc
跆	lckg
踯	lsb
踽	ltk
蹀	lkd
辎	lvl
郛	ebb
鄜	sxbh
钇	qnn
锎	que
镆	qsy
镓	qpe
镔	qpru
镘	qjl
镡	qsv
镦	qyb
颃	ynd
饔	yxth
饣	htn
饽	hfp
馓	haet
骱	xwj
髃	xjmc
髟	vet
魉	qce
鲌	ckg
鳓	cqlt
鸫	aiq
鹎	rvqg
鹩	duj
鹱	qga
鼽	tpv
龀	cbx
龁	cbs
龃	cbe
伾	wggg
俅	wfy
俜	wnw
俣	wkgd
俵	wgk
傺	www
劼	fkl
咇	kno
哳	krr
噀	kllr
坉	fba
坬	foc
坽	fdy
垎	fog
垏	fwf
垙	fkn
垿	focs
埆	fqeh
埌	fyv
堌	fld
堎	ffm
堲	vbf
堽	flg
塅	fnxy
墣	foay
媖	vam
岨	meg
峱	vnfm
崁	mfq
崚	mfm
崤	mre
嵁	mhnn
帱	bof
廴	pny
弢	xbc
戤	eclx
扆	oyk
拃	rkfg
揳	rdh
搌	rnae
枹	sql
柊	stu
栒	sqj
桊	xsu
棨	ots
楩	swgr
沄	icy
泐	ibl
浛	idk
湴	iuog
溇	iov
溦	imgt
漭	iad
澴	ilrk
煋	ojp
狝	vqi
狳	vwiy
狻	vcmt
獴	vap
瑷	gjd
璆	gnw
璈	ggt
甗	hrm
疍	wjgf
疢	uoi
痃	uaci
砘	dba
砟	dkfg
砫	dbg
硇	dtk
碥	dom
磉	dco
礓	dgl
禚	ougo
秬	tang
稃	teb
窀	pba
窅	phf
笸	tak
筢	trj
筲	tief
绤	xmrg
绱	xjg
缂	xqh
缊	xjlg
缋	xxm
缌	xln
缡	xyb
罨	ldj
翀	nsh
翾	lrk
耠	diw
聍	bpsh
肀	wng
肭	emw
肷	eqw
胙	ekfg
胲	eaoy
脬	eeb
舾	esg
艏	eqg
苊	adlb
苠	ane
茳	aiaf
荽	aev
莛	aqp
莰	afqw
莴	akm
菉	aji
葸	aln
蒗	aiyv
蕰	aij
蕻	avr
薳	afkp
蚨	jay
蚵	jskg
蛱	jxw
蛳	jjk
蜾	jjs
蝤	jus
螬	jem
螵	jbi
蟪	jgj
蟮	jpu
蠖	jar
蠼	jhhc
裎	bkgg
觖	qeb
謦	fnhy
诖	yff
谳	yhe
贶	mkq
趼	leh
跏	lvg
蹰	lda
轷	ltu
辁	lox
辒	ljl
邿	ffyb
鄗	hkb
酃	fxkb
酲	skgg
醅	sukg
銎	anbu
鐾	dabu
钆	qnn
铌	qnxn
铑	qfx
锓	qvp
锖	qge
锩	qxl
锪	qqr
锫	quk
锾	qegc
锿	qyky
镅	qnh
镝	qed
阃	uls
陞	bta
靸	qey
颟	aea
颥	fdmm
飑	nrq
骀	cck
骘	bcic
骣	cnb
鲆	cfu
鲐	cckg
鲱	cmxg
鲳	cjjg
鲴	cldg
鳣	cyl
鹀	aaq
鹡	iweg
鹣	uvog
鹧	loqg
鹪	roq
麀	sxxv
麑	sxvq
黉	ianu
黢	bcm
黧	tqt
龆	cbvk
亠	yyg
亹	ywf
仡	wsn
仳	waxn
倕	wqa
偾	wfam
僇	wnwe
僬	wro
剀	mljh
剞	dskj
勹	qtn
咉	kmdy
咍	kck
圌	lmdm
坥	feg
垾	fjfh
埇	fce
埪	fps
埫	fjg
埼	fds
堐	fdf
堧	fdmd
堨	fjqn
塝	fup
墐	fqf
墡	fpu
姈	vdy
姮	vgj
姽	vqdl
婞	vfuf
婻	vhe
嬬	vfd
寁	pgv
尜	idi
峂	mtuy
峧	mur
崄	mwq
崟	mbu
崿	mxgw
嵎	mjm
帡	bueh
庼	oad
悢	nyv
惎	hniu
惙	nooy
愐	ndl
慥	nek
慬	nqf
憕	nwg
憝	ybti
抃	ryh
挦	rvf
揕	rhnn
搒	rup
擿	redp
敔	skt
昄	jrc
昪	jca
昽	jdx
暌	jwgd
枵	skw
柃	sdy
柈	svu
桫	sii
桲	sfp
棓	sukg
棪	soo
棻	amvs
棽	mdb
椹	shnn
楱	sdwd
榅	sjlg
榍	snie
榘	cans
檑	sflg
毪	cncp
沘	iaxn
沨	inry
浐	iut
浠	ird
涫	ipd
淏	ijgd
湲	iegc
溠	ipag
滍	ibgj
滠	iboy
滫	iwh
漶	iski
澉	inbt
澪	ifdy
灬	oyy
爔	ougy
牿	nekg
玕	gfh
珅	gjhh
瑭	gow
甏	faen
畯	lcm
疬	udl
痄	ukf
瘌	uuj
瘭	ubi
瘰	ulx
盉	tlf
盦	dsl
眍	har
眵	hqy
硭	dayn
碡	dgx
窆	ptp
笊	toh
笯	tvc
筘	trk
筚	taxf
篼	tqk
簠	tbl
縠	fpgx
纛	gxs
纴	xqg
绋	xxj
翯	nhkf
耑	mdmj
耔	dib
耖	diit
耰	didt
脎	ejy
脶	ekm
舯	esh
艟	euu
艨	eapu
芃	anu
芄	avy
苘	amkf
苾	ano
荛	axp
荭	axaf
菥	asrj
萆	arv
萩	ato
葙	atf
葜	adhd
蒈	aaxk
蓰	ahcc
蕹	ayx
虍	hhg
虼	jsn
蛘	jph
蛲	jxpn
蛴	jcj
蝣	jpb
蝥	ctj
螋	jvh
蟛	jfa
袆	bvnn
袷	bwg
裈	bpl
裣	bwqg
裰	boo
襁	bxk
觫	qeuy
谫	yuw
趑	kki
跫	anl
跸	laxf
踬	lrfm
轹	lqi
辋	lmu
遹	cmrp
郾	ajv
酡	spxn
醑	swe
醵	sheu
钷	qak
铘	qrt
铴	qivt
铼	qxi
锍	qych
锜	qds
镚	qme
镤	qoa
镧	qus
镩	qps
镱	qxn
阌	ujc
阢	bpn
隃	bww
鞲	qem
驵	ceg
骎	cvp
骙	cwg
髎	xnwe
髑	xlq
髫	vevk
鲙	coc
鲰	cbcy
鳐	cer
鳟	cusy
鸧	wlq
鸰	dyq
鸶	xxgg
鸸	dmq
鸺	wsq
鹇	usq
鹚	uoq
鹨	nweg
鹮	lrkg
鹾	vrp
黟	bqy
鼗	iqf
龉	cbsk
䃅	dul
伋	wey
佽	wky
凓	uss
勍	yil
匜	amv
叕	oou
叚	rncy
呇	hik
咡	kbg
哃	kmg
噂	kus
噇	kuua
圐	llp
圙	lmdf
圢	fsh
圫	fmn
圲	fqh
坋	fmv
墕	fgc
壸	fpgo
夐	qmwt
娵	vbc
婍	vdsk
媞	vjw
嫄	vdk
嫕	vac
嫪	vnwe
嫭	vht
嫽	vdui
宬	ppx
岊	jmj
峛	mbj
崒	mya
嵖	msj
嵲	mts
嶅	gtmj
嶓	mml
嶦	mqdy
嶲	mrm
巇	mhg
幖	bbi
幪	bap
庤	off
廑	oqf
弇	waj
忞	cni
悈	nxa
慆	nev
扅	oqi
扊	oooi
挓	rpm
攽	mvt
旴	jfhh
昈	jot
昣	jwe
昤	jdyy
昺	jew
晙	jcm
朳	smy
杙	say
杧	syn
柷	skq
栻	saa
梣	smd
梴	stc
梾	sxi
梿	slpy
棁	sdq
棐	mxsu
棫	sxk
椑	srv
楪	skds
楯	srfh
槜	sre
毌	xfd
毐	fxd
毹	wwc
氆	cnu
氇	cncj
沲	itm
泂	imk
泃	isg
泚	icx
洈	iqdl
洴	iue
浉	ijk
浕	inmu
浡	ifpb
浭	igjr
涐	iryy
涢	ikmy
淯	iyce
湑	iweg
滪	ics
漈	iwwm
潟	ivq
潩	ilry
潽	iuoj
瀵	iol
炘	orh
炟	ojg
烺	oyvy
煴	ojl
熜	otk
熥	oce
熳	ojlc
犏	nom
犨	rrpj
狉	vgg
狴	vaxf
玃	vhh
玘	gln
玹	gacy
珣	gqjg
瑨	ggo
瑳	gpa
瓞	ocr
甪	tek
畬	wil
疐	fplw
痓	uad
皲	plh
眙	hckg
眬	hdx
睎	hrd
瞵	hob
矧	cxh
硎	dejh
硚	dmjh
祃	ocg
禤	olng
窕	piqb
筜	tiv
筼	tkmu
箢	tpq
篚	tam
籥	twxa
粝	odq
粢	kou
粿	ojsy
缐	xkh
羰	pmd
翛	whtn
耢	dial
脔	pmi
脞	eafg
腯	erf
腽	ejlg
膣	epa
艎	ekgg
茓	apu
莶	awqf
葴	adr
蒨	awge
蓂	apju
蓢	ayve
蓣	acs
薷	afdm
蘘	ayxk
蝓	jww
蝾	jap
螗	jow
蠓	japu
衠	hfew
褊	bom
訚	uyd
诼	yeu
貆	egj
赆	mnm
赇	mfy
赑	mmm
跐	lcx
踔	lhvh
軎	lkf
轺	lvkg
轾	lag
遆	upbp
钸	qdb
铈	qvm
铕	qefg
铚	qag
铞	qkbh
铥	qtl
铽	qani
锘	qat
锬	qoo
镄	qxj
镥	qcj
镨	quo
镴	qvku
靿	qxlt
鞔	qls
鞬	qwfp
韨	vndc
馌	hllg
鲊	ckfg
鲒	cfk
鲕	cdmh
鲩	cpf
鲹	ccde
鳉	cuq
鳋	ccuj
鳘	xtc
鳡	cdr
鸬	hnq
鹋	alqg
鹛	nhhg
麖	sxyi
鼢	vum
䏡	ewm
䲟	csb
冏	mrd
冫	uyg
勔	dlj
坰	fmkg
姶	vwg
娀	vxdt
婌	vmt
婘	vxl
婤	vmf
婫	vja
媂	vup
媄	vug
媓	vkgg
媱	ver
嬥	vnr
孅	vaxg
宧	payj
尪	dng
屼	mpn
岞	mkfg
岠	man
峗	mqdl
峘	mgj
峿	mskg
崡	mbi
崶	mffy
嵅	mdr
嶍	mnk
嶒	mljg
嶟	mus
庱	ofm
弆	laj
弨	xvkg
弸	xeeg
彟	vfy
徛	hds
忺	nqw
恓	nsg
恔	nur
悆	win
悰	npw
愃	npgg
愭	nfx
憙	faki
憭	ndu
戣	wgdx
戭	pgnx
扂	ovd
扺	rsn
摏	rdwv
摛	ryb
摴	rfg
敩	ibt
斠	emfw
斶	rlq
旞	puep
旵	jmj
旿	jrhh
晅	jgjg
晊	jag
晪	jmr
晫	jhvh
晱	joo
暕	jsl
暲	jxfh
暵	jak
暿	jfak
朏	ebm
枅	seh
枍	smwn
枲	cks
栟	sue
栲	sfw
桯	skgg
梼	sofy
梽	sfn
椀	spq
榑	sbf
槱	sso
橞	sgji
殣	bqf
汈	ing
沺	ilg
泙	ifu
泶	ihiu
洑	iwd
洓	iei
洣	ioy
洿	idgw
渟	ihs
渼	iugd
湉	inq
湝	iaxk
溍	igo
溵	irv
溹	ifpi
滃	imc
漋	ibtg
漴	impm
漼	imrg
潖	iggj
澭	iyx
瀌	isxo
瀼	iyxk
炣	oskg
焌	ocm
熛	obi
燏	ocmr
牁	uskg
牂	uph
牚	jrtr
牤	nyn
猄	vyiy
玙	gqg
玼	gcx
珌	gno
琀	gdkg
琭	gji
瑀	gtkc
瑆	gjp
瑝	gkgg
瓿	ukg
疭	uai
癿	knn
皕	djd
皞	kkdf
眊	hcnn
矻	dsn
硁	dca
硍	dvy
礌	dfl
礤	daw
礵	dft
祊	opt
祋	oxy
稆	tkk
穄	tww
窭	pov
笾	tlpu
筅	teq
筥	tkkf
筻	tgjr
簉	tekp
簦	twg
糵	atdo
缏	xwg
罍	lllm
羓	pjn
膪	eupk
舡	eag
舥	ejn
舭	eax
艉	enc
荮	axfy
菂	akq
菼	aoo
藟	alll
藠	akkk
虷	jfh
蚆	jjn
蛑	jcp
蜎	jke
蜞	jhy
螣	exjy
袗	bwet
裼	bjqr
襜	bqd
訄	vyd
赙	mbf
趯	knrd
趵	lqy
跞	lqiy
跣	leqn
跬	lffg
踦	ldsk
蹜	lpwj
蹽	ldui
蹾	lyb
轪	ldy
迺	spi
邘	fhb
邲	nob
郚	skbh
鄀	atrb
鄫	ljb
酂	eqeb
酅	mrmb
酏	smn
酦	shd
酴	swi
酺	sby
鋆	fquu
铹	qap
锳	qam
镋	qjqn
镎	qwc
镟	qpwy
镠	qnw
陑	bdm
隩	bbo
靽	qvu
鞨	qjqn
鞮	qjw
鞴	qate
韂	qqd
颎	xod
饳	hbm
骍	cah
鬘	vej
魆	qca
鱽	cvt
鲀	cba
鲃	cjn
鲏	chc
鲺	cnt
鲼	cfa
鳢	cka
鸲	sqgg
鸻	hwqg
鹖	jqwg
鹝	rmug
鹠	qyvg
鼷	vued
龂	cbr
龢	wxkt
㑇	wqv
㑊	wpy
㘎	kun
㧟	ria
㸌	ofr
䝙	ear
䴔	urq
丏	gchk
佖	wno
佧	wmy
佸	wqg
侘	wpm
侴	wnfj
俍	wyv
俫	wxi
倞	wyiy
倻	wbb
偁	wem
偡	whnn
傉	wde
傒	wex
僎	wllr
剅	gajh
剕	mxjh
剟	oojh
劄	twj
哱	kfpb
垵	fpv
慭	xid
晐	jaoy
暶	jpw
朓	eiq
朸	slt
杄	sqh
杕	sdy
柖	svk
栐	syin
栴	stm
桹	syvy
梌	swiy
梠	skk
棤	sajg
棬	sxl
椪	suo
椸	spm
楒	slni
榃	mlf
榰	sfxj
橑	sdui
檞	sqep
櫆	sqcw
欂	saiy
歅	sfq
氿	ivn
汫	ixh
沇	icq
泇	ivg
洘	ifw
洢	iwv
洭	iag
浟	iwht
浰	itj
浲	itdh
涄	inw
涍	ifb
淜	iee
淟	imry
淴	iqri
渖	ipjh
渰	iwa
溁	iaps
溚	iaw
溞	icuj
滆	irm
滉	ijkn
滧	iurt
漦	fiti
漷	iybb
漹	igcq
漻	inwe
潾	iob
澛	icjg
澽	iheu
濋	imwy
瀔	ifpx
瀱	ildj
灈	ihh
炌	owj
烔	omg
烠	oef
烶	oqpy
烻	otcp
焞	oybg
煁	ohn
煃	odf
煓	omd
煟	oleg
熇	ohkg
熻	owng
燋	oro
爚	owx
爟	oaxr
牥	npt
牻	ndne
猇	vhnn
猰	vdh
猺	verm
玤	gdh
玶	gfu
琎	gxp
琫	gdw
璥	gas
璪	gkx
瓀	gfd
瓻	rdbn
甡	pgp
畖	loc
疁	lnw
癗	ufl
皭	kely
矞	cmrf
矰	clj
矼	dag
砮	vcd
碃	dge
磻	dml
祲	ovpc
祾	ofmt
禒	oxe
禔	ojw
禛	ofe
秾	tpk
穜	tuua
簃	ttq
簕	tql
糒	oat
縢	exx
繄	acxi
绹	xqr
羑	ugqy
耇	fsd
肸	emfh
胈	edcy
腒	end
膙	exk
臜	eeqm
苧	aps
茋	asc
荁	agjg
荓	aue
荙	adp
莙	avtk
莝	aaff
萣	apwu
葖	apdy
蒟	aus
蓇	axf
蕗	alof
虒	rhnv
蝲	juj
螠	juul
蠛	jal
衒	hacw
袯	bhd
褕	bwwh
褟	bjn
襫	bdd
觱	drxe
觿	qemr
赗	mjh
赪	foh
踶	ljw
蹅	lsj
蹐	liw
蹢	led
辀	ley
辌	lyiy
逴	hvp
郪	gwvb
鄃	wwb
鄌	owkb
鄘	oweb
醾	svoy
锧	qrf
锽	qkgg
镃	quoy
镈	qbf
镮	qlr
镵	qla
阘	ujn
陎	btsy
雊	srg
雱	fpr
霨	fnw
靰	qpn
靺	qgs
鞁	qhcy
鞡	qru
鞧	qusg
颋	qpd
飗	nrql
饻	hyk
馃	hjsy
馉	hxg
驲	cjg
髢	vemb
鱾	cln
鲉	cng
鲪	cvtk
鲬	cce
鲯	chy
鲾	crl
鳀	cjw
鳁	cjlg
鳂	cle
鳆	ctjt
鳈	ckh
鳑	cup
鳒	cuv
鳚	cnwy
鳠	carc
鳤	ctp
鸤	nqgg
鸼	eqgg
鹐	qvqg
鹔	vijg
鹟	mcng
鹢	uulg
鹲	apgg
黇	anuv
黪	bcd
鼒	fth
鼩	vusg
鼫	vud
鼱	vuge
齄	tpsg
齇	tph
𠙶	bbk
𠳐	kob
𡎚	fom
𡐓	fowi
㕮	kmy
㙍	foo
㙘	fsv
㙦	wiwf
㛃	dhvv
㛚	vce
㛹	vwgr
㟃	mnr
㠇	myin
㠓	mapu
㤘	nqv
㥄	nfm
㧑	rlu
㫰	jyvy
㬊	jegc
㬎	joou
㬚	jyc
㭎	smr
㭕	sly
㮾	yves
㰀	stqi
㳇	imy
㳘	iycq
㳚	idyy
㴔	iqvi
㵐	iduw
㶲	oeh
㸆	oekx
㺄	vww
㻬	gfg
㽏	iwaf
㿠	kkn
䂮	dhvd
䃎	ddqy
䅟	tcd
䌹	xmk
䎃	mfn
䎖	ljng
䏝	evc
䏲	eux
䐃	elty
䓖	aplr
䓛	anbm
䓨	aprm
䓫	ads
䓬	ahv
䗖	jmp
䗛	jwhe
䗪	loj
䗴	jtq
䜣	yrh
䢺	bmb
䢼	rbh
䣘	jfb
䦃	qafj
䲢	excg
䴓	kmqg
䴖	geqg
䶮	dxg
伈	wni
伣	wms
伭	wac
佁	wck
侂	womn
侹	wqp
倧	wpw
倴	wdf
偓	wna
偰	wdh
傃	wgx
僔	wus
儦	wsx
儳	wla
儴	wyx
冔	jkfh
凘	uhr
勚	kdml
勠	nwel
厖	ddn
叇	cvip
昒	jqrt
昡	jacy
汋	iqyy
浬	iua
焆	oke
猯	vmd
玒	gag
玓	gqyy
玞	gay
玱	gwl
玿	gvk
珇	geg
珋	gqt
珒	gwf
珕	gll
珖	gkn
珛	gef
珢	gvy
珫	gycq
珷	ggac
珸	gskg
珹	gpx
琄	gke
琔	gpwy
琟	grg
琡	gmt
琲	gmx
瑂	gnh
瑃	gdwj
瑅	gjw
瑑	gxe
瑓	gsl
瑔	gkh
瑖	gnx
瑧	gdwt
璒	gwg
璬	gkp
璮	gyl
璱	ggg
璲	gue
瓖	gyx
盷	hqu
睄	hie
瞫	hsv
砄	dby
砆	day
砵	djg
硊	dqdl
硔	dry
硙	dmln
硿	dps
碈	dsnj
碏	dajg
碨	dley
磏	duv
磜	dww
磹	dsv
祏	odg
稑	tfm
稙	tfeg
穙	toa
穟	tue
窊	pocu
窎	pqgf
竘	usg
竫	uqsh
筀	tfff
筤	tyvu
筦	tpfq
筶	tekf
箖	tmu
篯	tqg
簝	tdu
纼	xxh
绖	xag
缞	xyg
罶	lqyl
羖	pxy
羱	pdk
翂	nmv
翃	dcn
翈	ung
翷	obn
耏	dme
耤	diaj
胣	etm
脟	eef
脿	egk
舠	evt
舲	edy
艅	ewiy
芠	acu
苉	aaqb
茽	awsj
荄	aao
荖	afxb
菍	adn
萚	arcv
萳	ahef
萹	aoma
葎	ahwf
葰	awc
蒄	apfy
蒱	arb
蒻	axuu
蓏	aocc
蔀	aukb
蔃	axkj
蔈	abiu
蔊	aojf
薢	aqe
薸	aibi
薿	axc
藦	avc
藨	asx
虤	hnh
虸	jbg
蚄	jpt
蚲	jfu
蛃	jewy
蜐	jll
蝘	jajv
螱	nwmj
蟏	jav
蟓	jle
蟫	jsv
衃	tlg
衎	hfw
褯	blbh
襚	buep
觃	msb
觟	qeff
觭	qedk
詟	dxyf
讱	yvy
讻	ybh
诇	ymkg
谼	mrr
豮	euf
赒	mmf
跱	lffy
踒	ltv
鄑	gojb
鄚	sbh
醨	sybc
钖	qvt
铏	qejh
隺	prd
靬	qfh
鞳	qaw
馝	tjn
馞	tjfb
馧	tjj
骦	cft
髽	vea
鬒	vefu
鬶	amsh
鬷	rmut
魋	qcr
鲖	cmg
鲘	cfkg
鳛	cnk
鹒	ovwg
鹯	ylkg
鹴	ftq
黡	ddyb
𠅤	yln
𣗋	sjq
𣲗	ivnn
𣲘	ifs
𣸣	ifam
𤧛	gup
𤩽	ghey
𤫉	goy
𥔲	dxgw
𥕢	dem
𥖨	dkx
𥻗	osj
𦈡	xfdm
𦒍	uuan
𦙶	edg
𦝼	eov
𦭜	akuu
𦰡	aob
𧿹	lxs
𨐈	lkn
𨙸	fcb
𨚕	cab
𨟠	hhrb
𨭉	cgau
𨱇	qfy
𨱏	qawg
𨱑	qanu
𨱔	qusy
𨺙	bvq
𩽾	cpv
𩾃	cls
𩾌	cowi
𫞩	gae
𫟅	xyiy
㧐	roy
䁖	hov
䥽	qhd
䲠	cdw
䴕	bjqg
䴗	hdy
䴘	rhng
䴙	daq
匼	awd
媆	vdm
漖	ifbt
霅	fyf
饸	hwg
鲗	cmjh
鲝	pcd
鲿	cic
鹙	toq
鿍	fta
鿎	ddp
鿏	qgt
𪟝	gmlt
𪣻	fov
𪤗	fnwe
𪨰	mka
𪨶	mdlj
𪩘	mhe
𪾢	hms
𫄧	xtcp
𫄨	xrd
𫄷	xxn
𫄸	xqb
𫇭	alu
𫌀	bgmy
𫍣	ymg
𫍯	ydr
𫍲	yvh
𫍽	ylr
𫐄	lpn
𫐐	lvq
𫐓	lcsy
𫑡	kjnb
𫓧	qay
𫓯	qffg
𫓶	qke
𫓹	qhy
𫔍	qmlg
𫔎	qcmr
𫔶	uts
𫖮	mldm
𫖯	iqdm
𫖳	vtkm
𫗧	huy
𫗴	hyl
𫘜	ccy
𫘝	cby
𫘦	cqr
𫘧	cji
𫘨	cjwy
𫘪	cdk
𫘬	cex
𫚕	cjk
𫚖	cxc
𫚭	cvk
𫛭	vgq
𫟦	lue
𫟹	qry
𫟼	qdpy
𫠆	fcd
𫠊	cac
𫠜	cbvq
𫢸	wul
𫫇	kgoi
𫭟	far
𫭢	fwx
𫭼	fapl
𫮃	fulf
𫰛	vca
𫵷	mdlt
𫶇	mmp
𫷷	oqq
𫸩	xar
𬀩	jvn
𬀪	jmsn
𬂩	sxw
𬃊	srfm
𬇕	igq
𬇙	imy
𬇹	ilb
𬉼	oar
𬊈	ovfy
𬊤	oulf
𬌗	rtw
𬍛	gqi
𬍡	ivb
𬍤	gvf
𬒈	idf
𬒔	dce
𬒗	djm
𬕂	tamu
𬘓	xjh
𬘘	xps
𬘡	xld
𬘩	xqp
𬘫	xpf
𬘬	xge
𬘭	xmy
𬘯	xybg
𬙂	xpgu
𬙊	xbfg
𬙋	xyx
𬜬	aukf
𬜯	aeau
𬞟	acim
𬟁	arm
𬟽	jai
𬣙	yfhh
𬣞	ypg
𬣡	ygx
𬣳	yvy
𬤇	ysf
𬤊	yjw
𬤝	ygji
𬨂	lsn
𬨎	lusg
𬩽	vfyb
𬪩	spky
𬬩	qay
𬬭	qwx
𬬮	qhs
𬬱	qrh
𬬸	qsyy
𬬹	qjhh
𬬻	qhnt
𬬿	qvkg
𬭁	qxs
𬭊	qsf
𬭎	qpdc
𬭚	qybg
𬭛	qih
𬭤	qwn
𬭩	qmc
𬭬	qdhv
𬭯	qot
𬭳	qfa
𬭶	qby
𬭸	qob
𬭼	quep
𬮱	usfd
𬮿	bmln
𬯀	bcj
𬯎	bxmy
𬱖	ndm
𬱟	qdbm
𬳵	cgg
𬳶	cmk
𬳽	ceq
𬳿	cwi
𬴂	cmxg
𬴃	cdh
𬴊	cobh
𬶋	csg
𬶍	cpxn
𬶏	cqd
𬶐	ciq
𬶟	cujh
𬶠	cslg
𬶨	vlsc
𬶭	cww
𬶮	cfak
𬷕	bqgg
𬸘	ajvg
𬸚	vydg
𬸣	pqgf
𬸦	pcq
𬸪	mlq
𬹼	cbw
𬺈	cbdk
𬺓	cbm