㑇	wqvg
㑊	wpy
㕮	kmy
㘎	kunt
㙍	fooy
㙘	fsvg
㙦	wiwf
㛃	dhvv
㛚	vceh
㛹	vwgr
㟃	mnrg
㠇	myin
㠓	mapu
㤘	nqvg
㥄	nfmt
㧐	roy
㧑	rluy
㧟	rian
㫰	jyvy
㬊	jegc
㬎	joou
㬚	jyct
㭎	smry
㭕	sly
㮾	yves
㰀	stqi
㳇	imy
㳘	iycq
㳚	idyy
㴔	iqvi
㵐	iduw
㶲	oeh
㸆	oekx
㸌	ofrg
㺄	vwwh
㻬	gfgw
㽏	iwaf
㿠	kkn
䁖	hovg
䂮	dhvd
䃅	dulf
䃎	ddqy
䅟	tcde
䌹	xmkg
䎃	mfng
䎖	ljng
䏝	evcy
䏡	ewmy
䏲	euxt
䐃	elty
䓖	aplr
䓛	anbm
䓨	aprm
䓫	adsk
䓬	ahvj
䗖	jmpb
䗛	jwhe
䗪	loji
䗴	jtqp
䜣	yrh
䝙	eary
䢺	bmbh
䢼	rbh
䣘	jfbh
䥽	qhdc
䦃	qafj
䲟	csbh
䲠	cdwj
䲢	excg
䴓	kmqg
䴔	urqg
䴕	bjqg
䴖	geqg
䴗	hdyg
䴘	rhng
䴙	daqg
䶮	dxgd
一	gio
丁	sgh
七	aoa
万	gqe
丈	gri
三	dio
上	hao
下	ghi
丌	pgth
不	gnhy
与	qngg
丏	gchk
丐	gchk
丑	nfd
专	vcu
且	ehng
丕	ggf
世	kdd
丘	rgd
丙	ewi
业	ohhg
丛	agf
东	aii
丝	xxgf
丞	bigf
丢	tli
两	eai
严	godr
丧	fueu
丨	hee
个	otyh
丫	uhk
丬	uygh
中	shnh
丰	dhk
串	skd
临	jtkh
丶	yee
丸	vyi
丹	myd
为	lui
主	bygg
丽	gyu
举	cvj
丿	too
乂	rty
乃	ent
久	qyi
乇	mtgt
么	ogd
义	yri
之	pppp
乌	qngd
乍	kfd
乎	tuhk
乏	tpi
乐	qii
乒	rgtr
乓	rgyu
乔	mjk
乖	quxv
乘	tuxv
乙	nee
乜	nnv
九	voa
乞	stgn
也	mao
习	nud
乡	xte
书	hbyi
乩	vnn
买	ciwu
乱	qnn
乳	ebnn
乸	mxsi
乾	ksn
了	bnh
予	csj
争	qsj
事	nvd
二	fio
亍	wggh
于	fhk
亏	gwb
云	cggy
互	gxgd
亓	fjj
五	sio
井	xggh
亘	gjgf
亚	god
些	cxff
亟	bkcg
亠	yyg
亡	yygn
亢	ynb
交	uru
亥	aoi
亦	pygy
产	ute
亨	ybj
亩	ylf
享	ybf
京	yiu
亭	hsj
亮	hnb
亲	uiu
亳	hmb
亵	yhku
亶	ylkg
亸	ybuf
亹	ywfe
人	woa
亻	wth
亿	wnn
什	wfh
仁	wfg
仂	wlt
仃	wsh
仄	dwi
仅	wcy
仆	why
仇	wvn
仉	wnn
今	dtyn
介	wjk
仍	wet
从	aoa
仑	wxb
仓	wlb
仔	wbg
仕	wfg
他	wmn
仗	wgry
付	wfyy
仙	wmh
仝	waf
仞	wvyy
仟	wqh
仡	wsn
代	hyi
令	dyi
以	nwy
仨	wdg
仪	wyry
仫	wogg
们	wun
仰	wqbh
仲	wsh
仳	waxn
仵	wrhh
件	wph
价	wwjh
任	wqg
份	wmvt
仿	wpt
企	wcf
伈	wniy
伉	wynn
伊	wvtt
伋	weyy
伍	wsg
伎	wfcy
伏	wdyy
伐	wxy
休	wsy
众	wau
优	wdnn
伙	woy
会	ocu
伛	wary
伞	wuhj
伟	wvnn
传	wvcy
伢	wrtt
伣	wmsn
伤	wtlt
伥	whsy
伦	wwxn
伧	wwln
伪	wluy
伫	wpgg
伭	wacy
伯	wkg
估	wdg
伲	wnxn
伴	wvuy
伶	wdyy
伸	wjhh
伺	wnrg
似	wnwy
伽	wvg
伾	wggg
佁	wckg
佃	wlg
但	wjgg
位	wug
低	wscy
住	wbg
佐	wdag
佑	wtrg
体	wjg
何	wskg
佖	wnoy
佗	wpxn
佘	oiu
余	wii
佚	wrwy
佛	wxjh
作	wkfg
佝	wsg
佞	wfvg
佟	wtuy
你	fii
佣	weh
佤	wgny
佥	wqf
佧	wmy
佩	wnkm
佬	wfxn
佯	wph
佰	wdjg
佳	wffg
佴	wbg
佶	wfkg
佸	wqg
佺	woxg
佻	wiqn
佼	wury
佽	wky
佾	wmeg
使	wrry
侁	weqn
侂	womn
侃	wkqh
侄	wag
侈	wqy
侉	wdgw
例	wbjh
侍	wffy
侏	wtsy
侑	wefg
侔	wcph
侗	wmg
侘	wpmn
供	wry
依	wyky
侠	wxwy
侣	wkkg
侥	wxpn
侦	whmy
侧	wmjh
侨	wmjh
侩	wocy
侪	wcjh
侬	wpky
侮	wxy
侯	wncy
侴	wnfj
侵	wvpc
侹	wqpy
便	wgjr
促	wly
俄	wryy
俅	wfy
俊	wcmt
俍	wyvy
俎	ieg
俏	wieg
俐	wtjh
俑	wceh
俗	wmrg
俘	webg
俙	wrdb
俚	wuag
俜	wnwn
保	mkd
俞	wwj
俟	wccy
信	wyg
俣	wkgd
俦	wofy
俨	wgod
俩	weay
俪	wgyy
俫	wxiy
俭	wwqg
修	whte
俯	wowy
俱	weuy
俳	wmxg
俵	wgky
俶	wmtc
俸	wdwv
俺	wdjn
俾	wrvh
倌	wpdg
倍	wukg
倏	whty
倒	wajh
倓	wooy
倔	wnbm
倕	wqag
倘	wjg
候	whnc
倚	wdsk
倜	wmfk
倞	wyiy
借	wajg
倡	wjjg
倥	wpsg
倦	wxln
倧	wpwm
倨	wndg
倩	wgeg
倪	wvqn
倬	whvh
倭	wtvg
倮	wjsy
倴	wdfa
债	wgmy
倻	wbbh
值	wfeg
倾	wadm
偁	wemf
偃	wajv
假	wrnc
偈	wjqn
偌	watr
偎	wley
偏	woma
偓	wnag
偕	waxk
做	wdty
停	whsh
偡	whnn
健	wwfp
偬	wqri
偭	wdlf
偰	wdhd
偲	wlni
偶	wjmc
偷	wwwh
偻	wovg
偾	wfam
偿	wicy
傀	wqcy
傃	wgxi
傅	wbfy
傈	wssy
傉	wdey
傍	wupp
傒	wexd
傕	wprg
傣	wdwi
傥	wjqn
傧	wpru
储	wyfj
傩	wcrg
催	wmrg
傲	wgty
傺	wwwm
傻	wtkt
僇	wnwe
僎	wllr
像	wleu
僔	wusy
僖	wfak
僚	wdui
僦	wyin
僧	wljg
僬	wroy
僭	wlsj
僮	wuua
僰	eiew
僳	wsoy
僵	wglg
僻	wdah
儆	wast
儇	wlrk
儋	wqdy
儒	wfdm
儡	wlll
儦	wsxo
儳	wlay
儴	wyxk
儿	qqqq
兀	pgtn
允	cqb
元	fqb
兄	kqb
充	ycqb
兆	iqv
先	eqb
光	khyn
克	dqb
免	lsv
兑	dqb
兔	lsyi
兕	gbgq
兖	ucqb
党	jqb
兜	qknq
兢	dqdq
入	tyi
全	oxd
八	moi
公	mcu
六	uoi
兮	mwb
兰	uff
共	rghy
关	syty
兴	coa
兵	rguu
其	hghy
具	euu
典	mri
兹	uou
养	pjk
兼	uvou
兽	ulrf
冀	uxlr
冁	ulfe
冂	mhn
内	mwi
冈	mri
冉	mfd
册	ygd
再	ked
冏	mrd
冒	jhf
冔	jkfh
冕	jlsb
冖	pyn
冗	pnb
写	pqf
军	plj
农	pki
冠	pfqy
冢	peuy
冤	plsy
冥	pjuu
冫	uyg
冬	tuu
冮	uag
冯	ucg
冰	uhiy
冱	ugxg
冲	ush
决	uby
况	ukqn
冶	uckg
冷	udyy
冻	uaiy
冼	ueqn
冽	ubjh
净	uqsh
凄	ugwv
准	urg
凇	usmc
凉	uyiy
凋	umfk
凌	ufmt
减	udry
凑	udwd
凓	ussy
凘	uhrh
凛	uylm
凝	uxcw
几	ntn
凡	ntny
凤	nci
凫	qnv
凭	wqnb
凯	mlnn
凰	nkgd
凳	wgan
凵	bnh
凶	btyh
凸	gmgb
凹	gbgb
出	bmk
击	fmk
凼	hibk
函	bibk
凿	oufb
刀	vnt
刁	ngd
刂	jhh
刃	vyi
分	mvr
切	avt
刈	rjh
刊	fjh
刍	qvf
刎	qrjh
刑	ejh
划	xjh
刖	wtnh
列	bjh
刘	cjh
则	mjh
刚	mrjh
创	wljh
初	bvt
删	ygjh
判	ojh
刨	qljh
利	tjh
别	vjh
刬	gxjh
刭	cajh
刮	qjh
到	ajh
刳	dgwj
制	ljh
刷	nbjh
券	xvr
刹	jjh
刺	eijh
刻	aojh
刽	ocjh
刿	mqjh
剀	mljh
剁	nsjh
剂	cjjh
剃	uxjh
剅	gajh
削	iejh
剋	dqjk
剌	ujh
前	uwj
剐	kmwj
剑	wqjh
剔	jqrj
剕	mxjh
剖	ukjh
剜	pqbj
剞	dskj
剟	oojh
剡	oojh
剥	jijh
剧	ndjh
剩	tuxj
剪	uwvr
副	rljh
割	jrjh
剽	bijh
剿	vjsj
劁	rojh
劂	dubj
劄	twjh
劈	davr
劐	arcj
劓	tpjh
力	lao
劝	clt
办	lmi
功	alt
加	vntg
务	tlr
劢	gqlt
劣	itlr
动	clt
助	elt
努	vclr
劫	llt
劬	slt
劭	vklt
励	dqlt
劲	calt
劳	aplr
劼	fklt
劾	aolt
势	hlr
勃	fpbl
勇	celr
勉	lsle
勋	kmlt
勍	yilt
勐	bllt
勒	qlt
勔	dljl
勖	jhlt
勘	hnlt
勚	kdml
募	slr
勠	nwel
勤	qflt
勰	llli
勹	qtn
勺	qyi
勾	qci
勿	qre
匀	qud
包	qlv
匆	qryi
匈	qbk
匍	qbi
匏	dgwl
匐	qrld
匕	xtn
化	hthn
北	uxn
匙	jwxv
匚	agn
匜	amv
匝	abk
匠	ark
匡	agd
匣	auk
匦	alvv
匪	amxd
匮	axmi
匹	aqv
区	ari
医	aci
匼	awd
匾	aoma
匿	aatr
十	foa
千	qtgh
卅	gjk
升	taj
午	rhk
卉	faj
半	vui
华	mxv
协	flmy
卑	rvk
卒	yafj
卓	hvj
单	ulfj
卖	viwu
南	heuf
博	fbfy
卜	hhy
卞	yhu
卟	khy
占	vhgg
卡	mhgy
卢	hnr
卣	vnd
卤	vri
卦	ffhy
卧	ayhy
卩	bnh
卫	nxd
卬	qbh
卮	flv
卯	qtbh
印	sbh
危	qdlb
即	vbh
却	lbh
卵	qyty
卷	xlb
卸	rcbh
卺	bigl
卿	qtvb
厂	dgt
厄	dlv
厅	dsk
历	dle
厉	dqe
压	dfyi
厌	ddyi
厍	dlk
厕	dmjk
厖	ddne
厘	duad
厚	djbd
厝	dajd
原	dkii
厢	dtd
厣	ddyu
厥	dubw
厦	ddht
厨	dafy
厩	dvls
厮	dhrk
厶	cny
去	lhgy
厾	nli
县	ecu
叁	cddf
参	cder
叆	cjdc
叇	cvip
又	cny
叉	cui
及	eyi
友	dci
双	oeo
反	rci
发	hdci
叔	mtcy
叕	oou
取	bcy
受	jcu
变	pcu
叙	wicy
叚	rncy
叛	orcy
叟	vhcu
叠	cope
口	kkkk
古	dghg
句	stng
另	vhnt
叨	kvt
叩	nhnh
只	kuu
叫	knhh
召	vkf
叭	kmy
叮	ksh
可	skd
台	ckf
叱	kxn
史	kri
右	trd
叵	akd
叶	kfh
号	kwb
司	nrd
叹	kcy
叻	klt
叼	kngg
叽	knn
吁	kfhh
吃	ksn
各	oa
吆	kxy
合	wtyg
吉	fkf
吊	kbj
同	mao
名	qkd
后	fkd
吏	rri
吐	kfg
向	bkd
吒	kmn
吓	kghy
吕	kkf
吖	kuhh
吗	kcg
君	vtkd
吝	ckf
吞	gdkf
吟	kdn
吠	kdyy
吡	kaxn
吣	kniy
否	gkf
吧	kjn
吨	kban
吩	kmvt
含	dkf
听	krh
吭	kynn
吮	kcqn
启	okd
吱	kfcy
吲	kxhh
吴	kgdu
吵	kitt
吸	keyy
吹	kqwy
吻	kqrt
吼	kbnn
吽	kph
吾	skf
呀	krtt
呃	kdln
呆	ksu
呇	hikf
呈	kgf
告	ekf
呋	kay
呐	kmwy
呒	kfsn
呓	kann
呔	kduy
呕	kary
呖	kdlt
呗	kmy
员	kmu
呙	kmwu
呛	kwln
呜	kqng
呢	knxn
呣	kxsy
呤	kdyy
呦	kxlt
周	mfkd
呱	kocy
呲	kcxn
味	kfiy
呵	kskg
呶	kvcy
呷	kuh
呸	kggg
呻	kjhh
呼	ktuh
命	wnj
咀	keg
咂	kabh
咄	kbmh
咆	kqln
咇	knoy
咉	kmdy
咋	kkfg
和	tkg
咍	kckg
咎	thkf
咏	kyin
咐	kwfy
咒	xnb
咔	kmy
咕	kdg
咖	kvg
咙	kdxn
咚	ktuy
咛	kpsh
咝	kxxg
咡	kbg
咣	kkn
咤	kpmn
咥	kag
咦	kgxw
咧	kbjh
咨	kkf
咩	kph
咪	koy
咫	nmku
咬	kury
咭	kfkg
咯	kog
咱	ktg
咳	kaoy
咴	kdoy
咸	drxy
咺	kgjg
咻	kwsy
咽	kldy
咿	kwvt
哀	yku
品	kxf
哂	ksg
哃	kmg
哄	kry
哆	kqy
哇	kffg
哈	kwg
哉	jkd
哌	krqu
响	kbkg
哎	kary
哏	kvy
哐	kagg
哑	kgog
哒	kdpy
哓	kxpn
哔	kaxf
哕	kmqy
哗	kmxn
哙	kocy
哚	knsy
哜	kcjh
哝	kpky
哞	kcph
哟	kxqy
哢	kgah
哥	aoe
哦	kryy
哧	kfoy
哨	kieg
哩	kuag
哪	kobh
哭	xdyu
哮	kfbg
哱	kfpb
哲	rrkf
哳	krrh
哺	kby
哼	kybh
哽	kgjr
哿	vskf
唁	kyg
唆	kcmt
唇	dekd
唉	kccy
唏	krdb
唐	owkd
唑	kafg
唔	kskg
唛	kgty
唝	kamy
唠	kapl
唢	kimy
唣	kkan
唤	kqmd
唧	kvbh
唪	kdwv
唬	khnn
售	rkf
唯	krg
唰	knbj
唱	kjjg
唳	kody
唵	kdjn
唷	kyce
唼	kuvg
唾	kqag
唿	kqri
啁	kmfk
啃	kceg
啄	keuy
商	erd
啉	kmy
啊	kbsk
啐	kyaf
啕	kqrm
啖	kooy
啜	kooy
啡	kmxg
啤	krvh
啥	kbkg
啦	krug
啧	kgmy
啪	krkg
啫	kfjg
啬	fulk
啭	klvc
啮	kcbh
啰	klqy
啴	kulf
啵	kihc
啶	kpwy
啷	kyvb
啸	kvij
啻	upbk
啼	kupb
啾	ktoy
喀	kpog
喁	kjmc
喂	kley
喃	khef
善	purf
喆	fkfk
喇	kujh
喈	kaxk
喉	kwnc
喊	kdry
喋	kkds
喏	katr
喑	kxg
喔	knag
喘	kmdm
喙	kxeu
喜	fakf
喝	kjqn
喟	kleg
喤	kkgg
喧	kpgg
喱	kdua
喳	ksjg
喵	kalg
喷	kfam
喹	kdff
喻	kwwh
喽	kovg
喾	iekf
嗄	kdht
嗅	ktdy
嗉	kgxi
嗌	kuul
嗍	kube
嗐	kjrg
嗑	kllg
嗒	kawg
嗓	kcos
嗔	kfeu
嗖	kvhc
嗜	kfxj
嗝	krmh
嗞	kuoy
嗟	kpag
嗡	kmcn
嗣	kmar
嗤	kbgj
嗥	kkdf
嗦	kfpi
嗨	kcuy
嗪	kdwt
嗫	kboy
嗬	kawk
嗯	kldi
嗲	kmqy
嗳	kjdc
嗵	kcep
嗷	kgty
嗽	kuqw
嗾	kpcy
嘀	kedg
嘁	kdmy
嘈	kemj
嘉	favf
嘌	kbiy
嘎	kdhx
嘏	drnc
嘘	khog
嘚	khxh
嘛	kvy
嘞	kqlt
嘟	kfjb
嘡	kjfg
嘣	kmee
嘤	kmmv
嘧	kpnm
嘬	kjbc
嘭	kfae
嘱	kntc
嘲	kkeg
嘴	kcxe
嘶	khrh
嘹	kdui
嘻	kfak
嘿	kby
噀	kllr
噂	kusy
噇	kuua
噌	kljg
噍	kroy
噎	kfpa
噔	kwga
噗	koay
噘	kduw
噙	kwyc
噜	kcjg
噢	kbod
噤	kmwm
器	xdyx
噩	gxxd
噪	kkxs
噫	kxni
噬	ktaa
噱	kheu
噶	kajn
噻	kpfg
噼	kdah
嚄	karc
嚅	kfdm
嚆	kahk
嚎	kheu
嚏	kfpw
嚓	kpwm
嚚	xayx
嚣	xdmx
嚭	fakk
嚯	kfrg
嚷	kyxk
嚼	kely
囊	npxk
囔	knpk
囗	lhng
囚	lwi
四	lio
囝	lbd
回	lkd
囟	tkri
因	ldi
囡	lvd
团	lfte
囤	lbav
囫	lqre
园	lfqv
困	lsi
囱	tkti
围	lvnv
囵	lwxv
囷	lti
囹	ldyi
固	ldd
国	lbi
图	ltui
囿	lefd
圃	lbi
圄	lskd
圆	lkmi
圈	lxlv
圉	lfuf
圊	lged
圌	lmdm
圐	llpe
圙	lmdf
圜	llrk
土	ffff
圢	fsh
圣	cff
在	djfd
圩	ffhh
圪	fsn
圫	fmn
圬	fgwn
圭	fff
圮	fln
圯	fln
地	fmn
圲	fqh
圳	fjh
圹	fot
场	fvt
圻	frh
圾	feyy
址	fcg
坂	frcy
均	fqug
坉	fban
坊	fpt
坋	fmvt
坌	mvff
坍	fmyg
坎	fqwy
坏	fgy
坐	afd
坑	fynn
坒	axff
块	fby
坚	tff
坛	fcy
坜	fdlt
坝	fmy
坞	fqng
坟	fcy
坠	bwff
坡	fhcy
坤	fjhh
坥	feg
坦	fjgg
坨	fpxn
坩	fafg
坪	ffut
坫	fvg
坬	focy
坭	fnxn
坯	fggg
坰	fmkg
坳	fxlt
坶	fxsy
坷	fskg
坻	fscy
坼	fryy
坽	fdyy
垂	qagf
垃	fug
垄	dxff
垅	fdxn
垆	fhnt
垈	hyff
型	ejff
垌	fmg
垍	ftg
垎	fog
垏	fwfg
垒	cccf
垓	faoy
垕	fkfd
垙	fkn
垚	ffff
垛	fnsy
垞	fpmn
垟	fph
垠	fvy
垡	wxff
垢	ffkg
垣	fgjg
垤	fag
垦	vff
垧	fbkg
垩	goff
垫	hff
垭	fgog
垮	fdgw
垯	fdpy
垱	fivg
垲	fmln
垴	fybh
垵	fpvg
垸	fpfq
垺	febg
垾	fjfh
垿	focs
埂	fgjr
埃	fccy
埆	fqeh
埇	fceh
埋	fuag
埌	fyvy
城	fpxy
埏	ftcp
埒	fefy
埔	fby
埕	fkgg
埗	fcit
埘	fjfy
埙	fkmy
埚	fkmw
埝	fdni
域	fxkg
埠	ftdf
埤	frvh
埪	fpsg
埫	fjg
埭	fviy
埯	fdjn
埴	ffeg
埵	fqag
埸	fjqr
培	fukg
基	hff
埼	fdsk
埽	fvpb
堀	fnbm
堂	jff
堃	ppff
堆	frg
堇	qfd
堉	fyce
堋	feeg
堌	fldg
堍	flsy
堎	ffmt
堐	fdff
堑	lrff
堕	beff
堙	fsfg
堞	fkds
堠	fwnc
堡	mkff
堤	fjwy
堧	fdmd
堨	fjqn
堪	fhnn
堰	fajv
堲	vbff
堵	ffjg
堼	ffff
堽	flgc
堾	fdwj
塄	flpt
塅	fnxy
塆	fpxn
塌	fjng
塍	exfg
塑	ubef
塔	fawg
塘	fowk
塝	fupp
塞	pff
塥	frmh
填	ffeu
塬	fdki
塱	yvef
塾	ybvf
墀	fnip
墁	fjlc
境	fxqn
墅	uacf
墈	fhnl
墉	fowe
墐	fqfg
墒	ferg
墓	sff
墕	fgcq
墘	fksn
墙	ffuk
墚	fivs
增	fljg
墟	fhog
墡	fpur
墣	foay
墦	fmlg
墨	bff
墩	fybt
墼	lbxf
壁	daff
壅	yxtf
壑	hpgf
壕	fheu
壤	fyxk
士	fghg
壬	qtgg
壮	ufg
声	fnhj
壳	fpnb
壶	fpof
壸	fpgo
壹	fpga
夂	ttny
处	thi
备	ofk
复	tjtu
夏	dhtu
夐	qmwt
夔	qclt
夕	qtny
外	qhy
夙	nbi
多	qoe
夜	ywty
够	sqy
夤	qpgu
夥	jsqy
大	doa
天	gdi
太	dui
夫	aaaa
夬	bngy
夭	myi
央	mdi
夯	dlr
失	rwi
头	iwi
夷	gxwi
夸	dgwb
夹	xwi
夺	dfyu
夼	djj
奁	daru
奂	qmdu
奄	djnb
奇	dskf
奈	dwmu
奉	dwvj
奋	dlf
奎	dfff
奏	dwgd
契	dhvd
奓	dqu
奔	dfaj
奕	pdu
奖	uqdu
套	dvu
奘	ufdu
奚	exdu
奠	usdu
奡	dhdj
奢	dfjf
奥	bodu
奭	ddjj
女	vvvv
奴	vcy
奶	vet
奸	vfh
她	vmn
好	vbg
妁	vqyy
如	vkg
妃	vln
妄	yvf
妆	uvg
妇	vvg
妈	vcg
妊	vqg
妍	veh
妒	vot
妓	vfcy
妖	vmyy
妗	vdn
妘	vcy
妙	vitt
妞	vnfg
妣	vaxn
妤	vcsh
妥	evf
妧	vfqn
妨	vpt
妩	vfsn
妪	vary
妫	vluy
妭	vdcy
妮	vnxn
妯	vng
妲	vjgg
妹	vfiy
妻	gwvf
妾	uvf
姆	vxsy
姈	vdyy
姊	vtnt
始	vckg
姐	veg
姑	vdg
姒	vnwy
姓	vpgg
委	tvf
姗	vygg
姘	vueh
姚	viqn
姜	ugvf
姝	vtsy
姞	vfkg
姣	vury
姤	vfkg
姥	vfxn
姨	vgxw
姬	vayh
姮	vgjg
姱	vdgw
姶	vwg
姹	vpmn
姻	vldy
姽	vqdl
姿	kvf
娀	vxdt
威	dvxy
娃	vffg
娄	ovf
娅	vgog
娆	vxpn
娇	vmjh
娈	pvf
娉	vnwn
娌	vuag
娑	iitv
娓	vncn
娘	vyvy
娜	vobh
娟	vkeg
娠	vdey
娣	vuxt
娥	vryy
娩	vlsn
娱	vkgd
娲	vkmw
娴	vusy
娵	vbcy
娶	bcvf
娼	vjjg
婀	vbsk
婆	ihcv
婉	vpql
婊	vgky
婌	vmtc
婍	vdsk
婕	vgvc
婘	vxln
婚	vsnj
婞	vfuf
婠	vpdg
婢	vrvh
婤	vmfk
婧	vgeg
婪	mvf
婫	vjax
婳	vglb
婴	mmvf
婵	vulf
婶	vpjh
婷	vhsh
婺	ctvf
婻	vhef
婼	vatr
婿	vweg
媂	vupb
媄	vugd
媆	vdmd
媒	vafs
媓	vkgg
媖	vamd
媚	vnhh
媛	vegc
媞	vjwy
媪	vjlg
媭	edmv
媱	verm
媲	vtkx
媳	vtni
媵	exvg
媸	vbgj
媾	vemf
嫁	vpeu
嫂	vvhc
嫄	vdki
嫉	vucy
嫌	vuvo
嫒	vjdc
嫔	vpru
嫕	vaci
嫖	vbiy
嫘	vlxi
嫚	vjlc
嫜	vxfh
嫠	fitv
嫡	vedg
嫣	vgcq
嫦	vjbh
嫩	vuty
嫪	vnwe
嫫	vsy
嫭	vhth
嫱	vfuk
嫽	vdui
嬉	vfak
嬖	davf
嬗	vylg
嬛	vlrk
嬥	vnrg
嬬	vfdm
嬲	llvl
嬴	yevn
嬷	vvog
嬿	vauo
孀	vftg
孅	vaxg
子	boe
孑	bnhg
孓	byi
孔	bnn
孕	ebf
孖	bbg
字	pbf
存	dhbd
孙	biy
孚	ebf
孛	fpbf
孜	bty
孝	fbd
孟	blf
孢	bqln
季	tbf
孤	bocy
孥	vcbf
学	ibf
孩	baoy
孪	pbf
孬	gvbf
孰	ybvy
孱	nbbb
孳	uobf
孵	qytb
孺	bfdm
孽	atdb
宀	pyyn
宁	psj
它	pxb
宄	pvb
宅	pmb
宇	pfhj
守	pfyu
安	pvf
宋	psu
完	pfqb
宏	pdcu
宓	pnou
宕	pdf
宗	pwmu
官	pdf
宙	pnf
定	pwu
宛	pqlb
宜	pef
宝	pbu
实	piwu
宠	pdxb
审	pjhj
客	pof
宣	pgjg
室	paf
宥	peff
宦	payj
宧	payj
宪	peqb
宫	pkkf
宬	ppxy
宰	paj
害	jrf
宴	pjvf
宵	pief
家	peuu
宸	pdeu
容	prf
宽	pams
宾	prgu
宿	pwdj
寁	pgvc
寂	pmtc
寄	pdsk
寅	pgnu
密	pnom
寇	pfqc
富	prlf
寐	pufi
寒	puu
寓	pjmc
寝	puvc
寞	psu
察	pwwm
寡	pdev
寤	pusk
寥	pnwe
寨	piu
寮	pdui
寰	plrk
寸	fyi
对	enyy
寺	ffyu
寻	vfyu
导	lfyu
寿	ofyi
封	fffy
射	yfyy
将	uqfy
尉	nwmy
尊	usfy
小	iiii
少	ite
尔	qiu
尕	eiu
尖	idu
尘	iff
尚	jao
尜	idiu
尝	icu
尢	dnv
尤	dnv
尥	dnqy
尧	xpb
尨	dnee
尪	dngd
尬	dnwj
就	yidn
尴	dnjl
尸	nngt
尹	vte
尺	nmi
尻	nvv
尼	nxv
尽	nmuu
尾	ncnv
尿	nhii
局	nsd
屁	naxv
层	nci
屃	nmi
居	ndd
屈	nbmk
屉	nkdd
届	nnd
屋	nad
屌	nkbk
屎	noi
屏	nuek
屐	nhfc
屑	nied
展	naei
屙	nbsk
属	ntkc
屠	nfjd
屡	novd
屣	nhcc
履	nhtt
屦	nhov
屮	bnhh
屯	bav
山	mmmm
屹	msn
屺	mln
屼	mpn
屾	mmh
屿	mqg
岁	mqu
岂	mlb
岈	mrtt
岊	jmj
岌	meyu
岍	meh
岐	mfcy
岑	mdb
岔	mvmj
岖	mary
岗	mmru
岘	mmsn
岙	mymj
岚	mnru
岛	qmk
岜	mjb
岞	mkfg
岠	mang
岢	mskf
岣	msg
岨	meg
岩	mdf
岫	mng
岬	muh
岭	mdyy
岱	hymj
岳	rgmj
岵	mdg
岷	mnen
岸	mdfj
岽	maiu
岿	mjvf
峁	mqtb
峂	mtuy
峃	imj
峄	mcvh
峋	mqjg
峒	mmg
峗	mqdl
峘	mgjg
峙	mffy
峛	mbjj
峡	mxwy
峣	mxpn
峤	mmjh
峥	mqsh
峦	pmj
峧	mury
峨	mryy
峪	mmrg
峭	mieg
峰	mtdh
峱	vnfm
峻	mcmt
峿	mskg
崀	myvu
崁	mfqw
崂	mapl
崃	mxiy
崄	mwqg
崆	mpsg
崇	mpwm
崌	mndg
崎	mdsk
崒	myaf
崔	mrf
崖	mdff
崚	mfmt
崛	mnbm
崞	mybg
崟	mbuf
崡	mbib
崤	mref
崦	mdjn
崧	msmc
崩	meef
崭	mlrj
崮	mldf
崴	mdvy
崶	mffy
崽	mlni
崾	msvg
崿	mxgw
嵁	mhnn
嵅	mdry
嵇	tdnm
嵊	mtux
嵋	mnhh
嵌	mafw
嵎	mjmc
嵖	msjg
嵘	maps
嵚	mqqw
嵛	mwwj
嵝	movg
嵩	mhkf
嵫	muoy
嵬	mqcu
嵯	mpag
嵲	mtsy
嵴	miwe
嶂	mxfh
嶅	gtmj
嶍	mnkg
嶒	mljg
嶓	mmlg
嶙	mobh
嶝	mwga
嶟	musy
嶦	mqdy
嶲	mrmm
嶷	mxcw
巅	mfem
巇	mhgx
巉	mlay
巍	mtvc
巛	vnnn
川	jthh
州	jii
巡	vpi
巢	vjsu
工	aghg
左	dad
巧	awn
巨	and
巩	any
巫	aai
差	pad
巯	cayh
己	llll
已	lyi
巳	lngn
巴	jnhn
巷	rlb
巽	llru
巾	bhnh
币	tbk
市	vmv
布	dbk
帅	jbh
帆	bny
师	jkmn
希	rdbj
帏	bvnn
帐	bhsy
帑	vcbj
帔	bhcy
帕	bkg
帖	bvg
帘	pbj
帙	brwy
帚	vpbj
帛	kbj
帜	bkuy
帝	upbj
帡	bueh
带	mpbj
帧	bhmy
帨	bdqn
席	lbk
帮	obbj
帱	bofy
帷	brg
常	jbj
帻	bgmy
帼	blby
帽	bjhg
幂	pjdb
幄	bnag
幅	brlg
幌	bjkn
幔	bjlc
幕	sbj
幖	bbiy
幛	bxfh
幞	boay
幡	bmlg
幢	buua
幪	bapu
干	fggh
平	fue
年	akk
并	uej
幸	fufj
幺	xnny
幻	xnn
幼	xlt
幽	xmxi
广	otyg
庀	oxv
庄	ofd
庆	odi
庇	oaxv
床	osi
庋	ofci
序	ocsk
庐	ooe
庑	ofsv
库	olk
应	oqd
底	osci
庖	oqlv
店	okd
庙	ond
庚	ovwi
府	owfy
庞	odxv
废	ohdc
庠	opk
庤	offy
庥	owsi
度	lci
座	oafd
庭	oqpi
庱	ofmt
庳	orvk
庵	odjn
庶	loi
康	owii
庸	owed
庹	lnmi
庼	oadm
庾	ovwi
廆	oqci
廉	ouvo
廊	oyvb
廋	ovhc
廑	oqfd
廒	ogti
廓	oybb
廖	onwe
廙	olri
廛	ouaf
廨	oqep
廪	oylm
廴	pny
延	tcpi
廷	qpi
建	wfpi
廾	agth
廿	aghg
开	eoa
弁	caj
异	laj
弃	ycaj
弄	gaj
弆	laj
弇	waj
弈	paj
弊	otaj
弋	agny
式	aad
弑	jaag
弓	xngn
引	xhh
弗	xjk
弘	xcy
弛	xmn
弟	uxr
张	xhsy
弢	xbcy
弥	xqiy
弦	xacy
弧	xocy
弨	xvkg
弩	vcxb
弪	xcag
弭	xbg
弯	pxb
弱	xuxu
弶	xyiy
弸	xeeg
弹	xulf
强	xkjy
弼	xdjx
彀	fpgx
彐	vngg
归	jvg
当	ivf
录	jii
彖	xeuu
彗	dhdv
彘	xgax
彝	xgoa
彟	vfyc
彡	ettt
形	eet
彤	myet
彦	utee
彧	akge
彩	eset
彪	hnee
彬	met
彭	faet
彰	xfet
影	kiet
彳	htth
彷	hpt
役	hxy
彻	havt
彼	hhcy
往	hbg
征	hgcg
徂	heg
径	hcag
待	hffy
徇	hqjg
很	hvy
徉	hph
徊	hlkg
律	hwfg
後	hxty
徐	hwiy
徒	hky
徕	hxiy
得	hxhh
徘	hmxg
徙	hccy
徛	hdsk
徜	hjg
御	hrcb
徨	hkgg
循	hrfh
徭	herm
微	hmgt
徵	hmgt
德	hlgi
徼	hkpt
徽	hmgt
心	nii
忄	nyyh
必	noi
忆	nnn
忉	nvt
忌	lniu
忍	vyni
忏	nqh
忐	hniu
忑	ghni
忒	anii
忖	nfyy
志	fniu
忘	yniu
忙	nyn
忝	gdiy
忞	cniu
忠	sniu
忡	nsh
忤	nrhh
忧	ndnn
忪	nmcy
快	nby
忭	nyhy
忮	nfcy
忱	npsn
忳	nban
念	dniu
忸	nnfg
忺	nqwy
忻	nrh
忽	qrni
忾	nen
忿	mvni
怀	ngy
态	duni
怂	aniu
怃	nfsn
怄	nary
怅	nhsy
怆	nwln
怊	nvkg
怍	nkfg
怎	kfni
怏	nmdy
怒	vcni
怔	ngcg
怕	nkg
怖	ndbh
怙	ndg
怛	njgg
怜	ndyy
思	lniu
怠	ckni
怡	nckg
急	qvni
怦	nfut
性	npgg
怨	qlni
怩	nnxn
怪	ncfg
怫	nxjh
怯	nly
怵	nsyy
总	dniu
怼	eniu
怿	ncvh
恁	wqni
恂	nqjg
恃	nffy
恋	pniu
恍	nkn
恐	anni
恒	ngjg
恓	nsg
恔	nury
恕	vkni
恙	ugni
恚	ffni
恝	dhvi
恢	ndoy
恣	kniu
恤	ntlg
恧	dmni
恨	nvy
恩	ldni
恪	nog
恫	nmg
恬	nqg
恭	riyu
息	tniu
恰	nwg
恳	vniu
恶	goni
恸	nclt
恹	nddy
恺	nmln
恻	nmjh
恼	nybh
恽	nplh
恿	ceni
悃	nlsy
悄	nieg
悆	wini
悈	nxah
悉	mniu
悌	nuxt
悍	njfh
悒	nkjn
悔	nxy
悖	nfpb
悚	nuy
悛	ncmt
悝	nuag
悟	nskg
悠	whti
悢	nyvy
患	skni
悦	ndqn
您	fini
悫	fpni
悬	ecni
悭	ntfg
悯	nucy
悰	npwm
悱	nmxg
悲	mxni
悴	nyaf
悸	ntbg
悻	nfuf
悼	nhvh
情	ngeg
惆	nmfk
惇	nybg
惊	nyiy
惋	npql
惎	hniu
惑	xkgi
惔	nooy
惕	njqr
惘	nmuy
惙	nooy
惚	nqri
惛	nsnj
惜	najg
惝	njg
惟	nrg
惠	gjci
惦	nokg
惧	neuy
惨	ncde
惩	hgci
惫	ofni
惬	naxw
惭	nlrh
惮	nulf
惯	nxfm
惰	ndae
想	tniu
惴	nmdm
惶	nkgg
惹	atri
惺	njpg
愀	ntoy
愁	toni
愃	npgg
愆	hiwi
愈	wwni
愉	nwwh
愍	neti
愎	ntjt
意	xniu
愐	ndlf
愔	nxg
愕	nxgw
愚	jmci
感	drxi
愠	njlg
愣	nlpt
愤	nfam
愦	nxmy
愧	nqcy
愫	ngxi
愭	nfxj
愿	dkii
慆	nevg
慈	uoni
慊	nuvo
慌	nayh
慎	nfeu
慑	nboy
慕	siyu
慝	aati
慢	njlc
慥	nekp
慧	dhdi
慨	nvls
慬	nqfg
慭	xidi
慰	nwmi
慵	nowe
慷	nowi
憋	otni
憎	nljg
憔	nroy
憕	nwga
憙	faki
憝	ybti
憧	nuua
憨	nbti
憩	qtni
憬	nkiy
憭	ndui
憷	nmwy
憺	nqdy
憾	ndri
懂	naqa
懈	nqep
懊	nbod
懋	mcni
懑	iaei
懒	nuqm
懔	nylm
懦	nfdm
懵	nalh
懿	fpgi
戆	xfti
戈	xgny
戊	dxyi
戋	gxi
戌	dxyi
戍	dyxy
戎	xde
戏	cxy
成	pxyi
我	ryi
戒	xak
戕	uxy
或	xkgd
戗	wlxy
战	vxy
戚	dmty
戛	dhxu
戟	kxy
戡	hnxy
戢	kbxy
戣	wgdx
戤	eclx
戥	jpgx
截	jrd
戬	gojx
戭	pgnx
戮	nwex
戳	nrxy
戴	jlri
户	oooo
戽	owk
戾	odyi
房	ope
所	lrh
扁	omak
扂	ovd
扃	omkd
扅	oqi
扆	oyki
扇	ond
扈	okjv
扉	omxd
扊	oooi
手	chk
扌	rrrr
才	fte
扎	rnn
扑	rhy
扒	rmy
打	rsh
扔	ret
托	rmn
扛	rag
扞	rfh
扣	rkg
扦	rqh
执	hghy
扩	rot
扪	run
扫	rvg
扬	rvt
扭	rnfg
扮	rmvt
扯	rcg
扰	rdnn
扳	rrcy
扶	ray
批	raxn
扺	rsnn
扼	rdln
扽	rban
找	rxy
承	bdii
技	rfcy
抃	ryhy
抄	ritt
抉	rby
把	rjn
抑	rqbh
抒	rcsh
抓	rohh
抔	rgy
投	rxy
抖	rwh
抗	rynn
折	rrh
抚	rfsn
抛	rvlt
抟	rvcy
抠	rary
抡	rwxn
抢	rwln
护	rot
报	riy
抨	rfut
披	rhcy
抬	rckg
抱	rqln
抵	rscy
抹	rgsy
抻	rjhh
押	ruh
抽	rng
抿	rnen
拂	rxjh
拃	rkfg
拄	rbg
担	rjgg
拆	rryy
拇	rxsy
拈	rvg
拉	rug
拊	rwfy
拌	rvuy
拍	rkg
拎	rdyy
拐	rvt
拒	rang
拓	rdg
拔	rdcy
拖	rtmn
拗	rxlt
拘	rsg
拙	rbmh
拚	rcah
招	rvkg
拜	mgdf
拟	rnwy
拢	rdxn
拣	raiy
拤	rmy
拥	reh
拦	rufg
拧	rpsh
拨	rhdc
择	rcvh
括	rqg
拭	raag
拮	rfkg
拯	rbig
拱	rry
拳	xchj
拴	roxg
拶	rvqy
拷	rfwn
拼	rueh
拽	rjxt
拾	rwg
拿	wchj
持	rffy
挂	rffg
指	rxjg
挈	dhvh
按	rpvg
挎	rdgw
挑	riqn
挓	rpmn
挖	rpnn
挚	hchj
挛	pchj
挝	rfyp
挞	rdpy
挟	rxwy
挠	rxpn
挡	rivg
挢	rmjh
挣	rqsh
挤	rcjh
挥	rplh
挦	rvfy
挨	rccy
挪	robh
挫	rafg
振	rdey
挲	iith
挹	rkjn
挺	rqpy
挽	rlsn
捂	rskg
捃	rvtk
捅	rceh
捆	rlsy
捉	rly
捋	refy
捌	rvjh
捍	rjfh
捎	rieg
捏	rjfg
捐	rkeg
捕	rby
捞	rapl
损	rkmy
捡	rwqg
换	rqmd
捣	rqmh
捧	rdwv
捩	rody
捭	rrvh
据	rndg
捯	rajh
捱	rdff
捶	rqag
捷	rgvc
捺	rdwm
捻	rdni
捽	ryaf
掀	rrqw
掂	rokg
掇	rooy
授	rjcy
掉	rhvh
掊	rukg
掌	jchj
掎	rdsk
掏	rqrm
掐	rqvg
排	rmxg
掖	rywy
掘	rnbm
掞	rooy
掠	ryiy
探	rosy
掣	ljch
接	ruvg
控	rpsg
推	rrg
掩	rdjn
措	rajg
掬	rqoy
掭	rgdy
掮	roeg
掰	mgmh
掳	rhlt
掴	rlby
掷	rsbh
掸	rulf
掺	rcde
掼	rxfm
掾	rxeu
揄	rwwh
揆	rwgd
揉	rcsy
揍	rdwd
揎	rpgg
描	ralg
提	rjwy
插	rqvg
揕	rhnn
揖	rkbg
揞	rxg
揠	rajv
握	rnag
揣	rmdm
揩	raxk
揪	rtoy
揭	rjqn
揲	rkds
揳	rdhd
援	regc
揶	rbbh
揸	rsjg
揽	rjms
揿	rqqw
搀	rlsu
搁	ruog
搂	rovg
搅	rims
搋	rrhn
搌	rnae
搏	rbfy
搐	racl
搒	rupp
搓	rpag
搔	rcuj
搛	ruvo
搜	rvhc
搞	rhkg
搠	rube
搡	rcos
搦	rxuu
搪	rowk
搬	rexy
搭	rawg
搴	pchj
携	rret
搽	rawi
搿	mgwh
摁	rldi
摄	rboy
摅	rhni
摆	rlly
摇	rerm
摈	rpru
摊	rcrg
摏	rdwv
摒	rnue
摔	racf
摘	redg
摛	rybc
摞	rlxi
摧	rmrg
摩	vchk
摭	rloy
摴	rfgw
摸	rsy
摹	schj
摺	rnkg
摽	rbiy
撂	rlog
撄	rmmv
撅	rduw
撇	roty
撑	rjch
撒	raet
撕	rhrh
撖	rnbt
撙	rusy
撞	ruua
撤	ryct
撩	rdui
撬	rcnn
播	rmlg
撮	rjbc
撰	rllr
撵	raal
撷	rfkm
撸	rcjg
撺	rpsk
撼	rdri
擀	rkwf
擂	rflg
擅	rylg
操	rkxs
擎	asth
擐	rlrk
擒	rwyc
擗	rdah
擘	dach
擞	rovt
擢	rnrg
擤	rtph
擦	rpwm
擿	redp
攀	midh
攉	rfrg
攒	reqm
攘	ryxk
攥	rthi
攫	rhhc
攮	rnpk
支	fcu
攴	hcu
攵	ttgy
收	nhty
攸	whty
改	lty
攻	aty
攽	mvty
放	pty
政	gcty
故	dty
效	urty
敉	oty
敌	qty
敏	xty
救	fty
敔	skty
敕	uty
敖	gty
教	fbty
敛	wqty
敝	oty
敞	jty
敢	nbty
散	aety
敦	ybty
敩	ibty
敫	kpty
敬	asty
数	ovty
敲	hkhc
整	utgc
敷	bpty
文	cygy
斋	cdmj
斌	cgac
斐	mxcu
斑	gcgg
斓	cusl
斗	wyyh
料	owh
斛	qewh
斜	wiwh
斝	xpwj
斟	hnwh
斠	emfw
斡	kwwh
斤	rtt
斥	ryi
斧	mrj
斩	lrh
斫	drh
断	onrh
斯	hrh
新	uirh
斶	rlqj
方	pygt
於	pwuy
施	pmv
旁	uppr
旃	pmyd
旄	pcnv
旅	pqui
旆	pgbk
旋	pwi
旌	ppgd
旎	pnxv
族	pci
旐	piqv
旒	pych
旖	pdsk
旗	phi
旞	puep
无	fsv
既	vlsn
日	jao
旦	jgf
旧	hjg
旨	xjf
早	vhnh
旬	qjd
旭	vjd
旮	vjf
旯	jvb
旰	jfh
旱	jfj
旴	jfhh
旵	jmj
时	jfyy
旷	jot
旸	jvt
旺	jgg
旻	jcu
旿	jrhh
昀	jqug
昂	jqbj
昃	jdwu
昄	jrcy
昆	jaxb
昇	jtaj
昈	jot
昉	jpt
昊	jgdu
昌	jjf
明	jeg
昏	snjf
昒	jqrt
易	jqrr
昔	ajf
昕	jrh
昙	jcu
昝	thjf
星	jpgf
映	jmdy
昡	jacy
昣	jwet
昤	jdyy
春	dwjf
昧	jfiy
昨	jkfg
昪	jcaj
昫	jsg
昭	jvkg
是	jwu
昱	juf
昳	jrwy
昴	jqtb
昵	jnxn
昶	yinj
昺	jewu
昼	nmjg
昽	jdxn
显	jof
晁	jiqb
晃	jkb
晅	jgjg
晊	jag
晋	gojf
晌	jbkg
晏	jpvf
晐	jaoy
晒	jsg
晓	jxpn
晔	jmxn
晕	jplj
晖	jplh
晗	jdkg
晙	jcmt
晚	jlsn
晞	jrdb
晟	jpxy
晡	jby
晢	rrjf
晤	jskg
晦	jxy
晨	jdeu
晪	jmry
晫	jhvh
普	uojf
景	kiu
晰	jsrh
晱	jooy
晴	jgeg
晶	jjjf
晷	jthk
智	ckjf
晾	jyiy
暂	lrjf
暄	jpgg
暅	jngg
暇	jrnc
暌	jwgd
暑	jfjf
暕	jslg
暖	jegc
暗	jxg
暝	jpju
暧	jjdc
暨	vlsg
暮	sjf
暲	jxfh
暴	jriu
暵	jaka
暶	jpwy
暹	jrpi
暾	jybt
暿	jfak
曈	juua
曌	jeps
曙	jlfj
曛	jqby
曜	jnrg
曝	jjri
曦	jugy
曩	jyxk
曰	jhnh
曲	kak
曳	jxe
更	gjri
曷	jqwn
曹	emjf
曼	jlcu
曾	ljf
替	aajf
最	jbcu
月	eeee
有	efd
朊	efqn
朋	eeg
服	eiy
朏	ebmh
朐	esg
朓	eiqn
朔	ubeg
朕	esy
朗	yveg
望	yegf
朝	keg
期	heg
朦	eapu
木	ssss
未	fii
末	gsi
本	jjjj
札	snn
术	syi
朱	tsi
朳	smy
朴	shy
朵	nsu
朸	slt
机	snn
朽	swn
杀	jtyy
杂	viu
权	scy
杄	sqh
杆	sfh
杈	scuy
杉	set
杌	spn
李	sbf
杏	skf
材	sftt
村	sfyy
杓	sqyy
杕	sdy
杖	sgry
杙	say
杜	sfg
杞	sln
束	ughy
杠	sag
条	tiu
来	xii
杧	syn
杨	svt
杩	scg
杪	sitt
杭	synn
杯	sgy
杰	sou
杲	jsu
杳	sjf
杵	srhh
杷	sjn
杻	snfg
杼	scsh
松	smcy
板	srcy
极	seyy
构	sqcy
枅	seh
枇	saxn
枉	sgg
枋	spt
枍	smwn
析	srh
枕	spsn
林	meo
枘	smwy
枚	sty
果	jsi
枝	sfcy
枞	say
枢	sary
枣	eiuu
枥	sdlt
枧	smsn
枨	shsy
枪	swln
枫	snry
枭	qsi
枯	sdg
枰	sfut
枲	cksu
枳	skuy
枵	skwn
架	vsu
枷	svg
枸	ssg
枹	sqln
柁	spxn
柃	sdyy
柄	sewy
柈	svuy
柊	stuy
柏	skg
某	afsu
柑	safg
柒	iasu
染	ivsu
柔	csu
柖	svkg
柘	sdg
柙	suh
柚	sng
柜	sang
柝	sryy
柞	skfg
柠	spsh
柢	sscy
查	sjgf
柩	saqy
柬	sld
柯	sskg
柰	swmu
柱	sbg
柳	sqtb
柴	cxsu
柷	skqn
柽	scfg
柿	svmn
栀	sfln
栅	sygg
标	swmy
栈	sgxy
栉	sabh
栊	sdxn
栋	saiy
栌	shnt
栎	sqiy
栏	sufg
栐	syin
树	sey
栒	sqjg
栓	soxg
栖	ssg
栗	ssu
栝	sqg
栟	sueh
校	sury
栩	sng
株	stsy
栲	sfwn
栳	sfxn
栴	stmy
样	sph
核	saoy
根	svy
栻	saag
格	sog
栽	jsi
栾	psu
桀	bsu
桁	shwh
桂	sffg
桃	siqn
桄	skn
桅	sqdl
框	sagg
案	pvsu
桉	spvg
桊	xsu
桌	hjsu
桎	sag
桐	smg
桑	cosu
桓	sgjg
桔	sfkg
桕	svg
桠	sgog
桡	sxpn
桢	shmy
档	sivg
桤	smln
桥	smjh
桦	smxn
桧	socy
桨	uqsu
桩	sofg
桫	siit
桯	skgg
桲	sfpb
桴	sebg
桶	sceh
桷	sqeh
桹	syvy
梁	ivms
梃	sqpy
梅	sxy
梆	sobh
梌	swiy
梏	sekg
梓	sah
梗	sgjr
梠	skkg
梢	sieg
梣	smdn
梦	mqu
梧	sskg
梨	tjsu
梭	scmt
梯	suxt
械	sxah
梳	sych
梴	stcp
梵	mnu
梼	sofy
梽	sfni
梾	sxiy
梿	slpy
检	swqg
棁	sdqn
棂	svoy
棉	skbh
棋	shy
棍	sjax
棐	mxsu
棒	sdwv
棓	sukg
棕	spwm
棘	eiei
棚	seeg
棠	jsu
棣	sviy
棤	sajg
棨	otsu
棪	sooy
棫	sxkg
棬	sxln
森	smu
棰	sqag
棱	sfmt
棵	sjsy
棹	shvh
棺	spdg
棻	amvs
棼	mmvr
棽	mdb
椀	spql
椁	sybg
椅	sdsk
椆	smfk
椋	syiy
植	sfeg
椎	srg
椐	sndg
椑	srvh
椒	smtc
椓	seuy
椟	sviw
椠	lrsu
椤	slqy
椪	suog
椭	sbef
椰	sbbh
椴	snxy
椸	spmn
椹	shnn
椽	sxeu
椿	sdwj
楂	ssjg
楒	slni
楔	sdhd
楗	swfp
楙	mce
楚	mwu
楝	sslg
楞	slpt
楠	shef
楣	snhh
楦	spgg
楩	swgr
楪	skds
楫	skbg
楮	sfjg
楯	srfh
楱	sdwd
楷	saxk
楸	stoy
楹	secl
楼	sovg
榀	skxg
概	svls
榃	mlf
榄	sjms
榅	sjlg
榆	swwh
榇	suiy
榈	sukk
榉	scvh
榍	snie
榑	sbfy
榔	syvb
榕	sprg
榖	fpgx
榘	cans
榛	sdwt
榜	supp
榧	samx
榨	spkf
榫	srfh
榭	syfy
榰	sfxj
榱	sygk
榴	sqyl
榷	sprg
榻	sjng
槁	shkg
槃	exsu
槊	ubes
槌	stdp
槎	spag
槐	sqcy
槔	skdf
槚	ssmy
槛	sjlg
槜	sret
槟	spru
槠	syfj
槭	sdmy
槱	ssoy
槲	sqew
槽	semj
槿	sqfg
樊	midu
樗	sfgw
樘	sjfg
樟	sxfh
模	ssy
樨	snip
横	sanu
樯	sfuk
樱	smmv
樵	sroy
樽	susy
樾	skay
橄	snbt
橇	scnn
橐	npds
橑	sdui
橘	scmr
橙	swga
橛	sduw
橞	sgji
橡	sleu
橥	vfjs
橦	suua
橱	sday
橹	scjg
橼	sxxu
檀	sylg
檄	skpt
檎	swyc
檐	sqdy
檑	sflg
檗	dasu
檞	sqep
檠	asts
檩	sylm
檫	spwm
檬	sapu
櫆	sqcw
欂	saiy
欠	qwu
次	kygy
欢	cqwy
欣	rqwy
欤	qqwy
欧	arqw
欲	mrqw
欷	rdbw
欸	ccqw
欹	dskw
欺	hqwy
欻	ooqw
款	fwmw
歃	qvqw
歅	sfqw
歆	xqwy
歇	jqww
歉	uvow
歌	aqwy
歙	wnqw
止	chgg
正	gcd
此	cxn
步	cir
武	gacd
歧	cfcy
歪	ggcf
歹	bgty
死	bxv
歼	bqh
殁	bxy
殂	beg
殃	bmdy
殄	bwet
殆	bckg
殇	btvt
殉	bqjg
殊	btsy
残	bgxy
殍	bebg
殒	bkmy
殓	bwqg
殖	bfeg
殚	bulf
殛	bbkg
殡	bpru
殣	bqfg
殪	bfpa
殳	xtny
殴	arxy
段	nxy
殷	rvnx
殿	nrxy
毁	vaxy
毂	fplx
毅	ueux
毋	xdd
毌	xfd
母	xsi
每	xxxx
毐	fxdf
毒	gxsu
毓	xych
比	axn
毕	axfj
毖	axno
毗	laxn
毙	axbx
毛	cnv
毡	cnvd
毪	cncp
毫	hcnb
毯	cnoo
毳	cncn
毵	cden
毹	wwcn
毽	cnwp
氅	jtcn
氆	cnuj
氇	cncj
氍	hhrn
氏	snv
氐	sci
民	nev
氓	ynen
气	etgn
氕	ete
氖	eee
氘	ejk
氙	emk
氚	ejk
氛	emve
氟	exjk
氡	etui
氢	ecad
氤	eldi
氦	eaoi
氧	epk
氨	epvd
氩	egod
氪	edqv
氮	eooi
氯	ejii
氰	eged
氲	ejld
水	hii
氵	iyyg
永	yinv
氽	whiu
氾	iln
氿	ivn
汀	ish
汁	ifh
求	foa
汆	tyhi
汇	ian
汈	ingg
汉	icy
汊	icuy
汋	iqyy
汐	iqy
汔	isn
汕	imh
汗	ifh
汛	infh
汜	iln
汝	ivg
汞	ahiu
江	iag
池	imn
污	igwn
汤	ivt
汧	ieh
汨	ijg
汩	ijg
汪	igg
汫	ixh
汭	imwy
汰	iduy
汲	ieyy
汴	iyhy
汶	icy
汹	ibh
汽	ien
汾	imvt
沁	iniy
沂	irh
沃	imyy
沄	icy
沅	ifqn
沆	iynn
沇	icqn
沈	ipsn
沉	ipnn
沌	iban
沏	iavt
沐	isy
沓	hijf
沔	igch
沘	iaxn
沙	iitt
沚	icg
沛	igbh
沟	iqcy
没	ixy
沣	idhh
沤	iary
沥	idlt
沦	iwxn
沧	iwln
沨	inry
沩	iluy
沪	iot
沫	igsy
沭	isyy
沮	ieg
沱	ipxn
沲	itmn
河	iskg
沸	ixjh
油	ing
沺	ilg
治	ickg
沼	ivkg
沽	idg
沾	ivg
沿	inkg
泂	imkg
泃	isg
泄	ikdg
泅	ilwy
泇	ivg
泉	khiu
泊	ikg
泌	inoy
泐	iblt
泓	ixcy
泔	iafg
法	ily
泖	iqtb
泗	ilg
泙	ifut
泚	icxn
泛	itpy
泜	iscy
泞	ipsh
泠	idyy
泡	iqln
波	ihcy
泣	iug
泥	inxn
注	ibg
泪	ihg
泫	iacy
泮	ivuy
泯	inen
泰	dwiu
泱	imdy
泳	iyin
泵	dhiu
泶	ihiu
泷	idxn
泸	ihnt
泺	iqiy
泻	ipqg
泼	ihdc
泽	icvh
泾	icag
洁	ifkg
洄	ilkg
洇	ildy
洈	iqdl
洋	iph
洌	ibjh
洎	itg
洑	iwdy
洒	isg
洓	ieiy
洗	ieqn
洘	ifwn
洙	itsy
洚	itah
洛	iog
洞	img
洢	iwvt
洣	ioy
津	iwfg
洧	iefg
洨	iury
洪	iry
洫	itlg
洭	iagg
洮	iiqn
洱	ibg
洲	ijiy
洳	ivkg
洴	iueh
洵	iqjg
洸	ikn
洹	igjg
洺	iqkg
活	iqg
洼	iffg
洽	iwg
派	irqu
洿	idgw
流	iych
浃	ixwy
浅	igxy
浆	uqhi
浇	ixpn
浈	ihmy
浉	ijkm
浊	ijy
测	imjh
浍	iocy
济	icjh
浏	icjh
浐	iutt
浑	iplh
浒	iyrh
浓	ipky
浔	ivfy
浕	inmu
浙	irrh
浚	icmt
浛	idkg
浜	irgu
浞	ily
浟	iwht
浠	irdb
浡	ifpb
浣	ipfq
浥	ikjn
浦	iby
浩	iekg
浪	iyvy
浬	iuag
浭	igjr
浮	iebg
浯	iskg
浰	itjh
浲	itdh
浴	imrg
海	cui
浸	ivpc
浼	ilsn
涂	iwiy
涄	inwn
涅	ijfg
消	iieg
涉	icit
涌	iceh
涍	ifbg
涎	itcp
涐	iryy
涑	iuy
涓	ikeg
涔	imdn
涕	iuxt
涘	iccy
涛	iofy
涝	iapl
涞	ixiy
涟	ilpy
涠	ilvn
涡	ikmw
涢	ikmy
涣	iqmd
涤	itiy
润	iugg
涧	iujg
涨	ixhs
涩	ivyc
涪	iukg
涫	ipdg
涮	inbj
涯	idff
液	iywy
涴	ipql
涵	ibib
涸	ildg
涿	ieuy
淀	ipwy
淄	ivlg
淅	isrh
淆	iref
淇	ihy
淋	imy
淌	ijg
淏	ijgd
淑	imtc
淖	ihvh
淘	iqrm
淙	ipwm
淜	ieeg
淝	iejn
淞	ismc
淟	imry
淠	ilph
淡	iooy
淤	ipwu
淦	ibug
淫	ieqg
淬	iyaf
淮	irg
淯	iyce
深	iosy
淳	iybg
淴	iqri
混	ijax
淹	idjn
添	igdy
淼	hihi
清	igeg
渊	itoh
渌	ijiy
渍	igmy
渎	iviw
渐	ilrh
渑	ikjn
渔	icg
渖	ipjh
渗	icde
渚	ifjg
渝	iwwh
渟	ihsh
渠	ians
渡	ilcy
渣	isjg
渤	ifpl
渥	inag
温	ijlg
渫	ikds
渭	ileg
港	irln
渰	iwah
渲	ipgg
渴	ijqn
游	ipbg
渺	ihit
渼	iugd
湃	imgf
湄	inhh
湉	inqg
湍	imdm
湎	idlf
湑	iweg
湓	imvl
湔	iuwh
湖	ideg
湘	itg
湛	ihnn
湜	ijwy
湝	iaxk
湟	ikgg
湣	inej
湫	itoy
湮	isfg
湲	iegc
湴	iuog
湾	ipxn
湿	ijog
溁	iaps
溃	ixmy
溅	imgx
溆	iwic
溇	iovg
溉	ivls
溍	igoj
溏	iowk
源	idki
溘	illg
溚	iawg
溜	iqyl
溞	icuj
溟	ipju
溠	ipag
溢	iuul
溥	ibfy
溦	imgt
溧	issy
溪	iexd
溯	iube
溱	idwt
溲	ivhc
溴	itdy
溵	irvx
溶	iprg
溷	ileu
溹	ifpi
溺	ixuu
溻	ijng
溽	idey
滁	ibwi
滂	iupp
滃	imcn
滆	irmh
滇	ifeu
滉	ijkn
滋	iuoy
滍	ibgj
滏	imfu
滑	ixg
滓	ipah
滔	ievg
滕	exiy
滗	itcn
滘	ioak
滚	iuck
滞	impb
滟	idhj
滠	iboy
满	iaea
滢	iapb
滤	ihni
滥	ijlg
滦	ipsy
滧	iurt
滨	ipru
滩	icrg
滪	icsm
滫	iwhe
滴	iedg
滹	ihth
漂	ibiy
漆	iswi
漈	iwwm
漉	isxn
漋	ibtg
漏	inmi
漓	iybc
演	ipgu
漕	iemj
漖	ifbt
漠	isy
漤	imvg
漦	fiti
漩	ipwy
漪	ivdk
漫	ijlc
漭	iada
漯	ilxi
漱	iuqw
漳	ixfh
漴	impm
漶	iski
漷	iybb
漹	igcq
漻	inwe
漼	imrg
漾	iugn
潆	iapi
潇	iavj
潋	iwqt
潍	ixrg
潏	icmr
潖	iggj
潘	imlg
潜	iaaj
潞	ilog
潟	ivqo
潢	ianu
潦	idui
潩	ilry
潭	isvh
潮	ikeg
潲	itie
潴	ivfj
潵	iaet
潸	imeg
潺	inbb
潼	iuua
潽	iuoj
潾	iobh
澂	imgt
澄	iwga
澈	iyct
澉	inbt
澌	ihrh
澍	ifay
澎	ifae
澛	icjg
澜	iusl
澡	ikxs
澥	iqep
澧	ikaa
澪	ifdy
澭	iyxr
澳	ibod
澴	ilrk
澶	iylg
澹	iqdy
澼	idah
澽	iheu
激	ikpt
濂	iouo
濉	ihrg
濋	imwy
濑	iuqm
濒	icim
濞	itph
濠	iheu
濡	ifdm
濩	iarc
濮	iwoa
濯	inrg
瀌	isxo
瀍	iouf
瀑	ijri
瀔	ifpx
瀚	ikwn
瀛	iyen
瀣	ihqg
瀱	ildj
瀵	iolr
瀹	iwxa
瀼	iyxk
灈	ihhr
灌	iaxr
灏	ikim
灞	ifqe
火	oyty
灬	oyyy
灭	goi
灯	osh
灰	doi
灵	vou
灶	ofg
灸	qyou
灼	oqyy
灾	pou
灿	omh
炀	ovt
炅	jou
炆	ocy
炉	oot
炊	oqwy
炌	owjh
炎	oou
炒	oitt
炔	oby
炕	oynn
炖	oban
炘	orh
炙	qoi
炜	ovnn
炝	owln
炟	ojgg
炣	oskg
炫	oacy
炬	oang
炭	mdou
炮	oqln
炯	omkg
炱	ckou
炳	oewy
炷	obg
炸	okfg
点	vou
炻	odg
炼	oaiy
炽	okuy
烀	otuh
烁	oqiy
烂	oufg
烃	ocag
烈	bjou
烊	oph
烔	omg
烘	ory
烙	oog
烛	ojy
烜	ogjg
烝	bigo
烟	oldy
烠	oefg
烤	ofwn
烦	odmy
烧	oxpn
烨	omxn
烩	oocy
烫	ivou
烬	onmu
热	hou
烯	ordb
烶	oqpy
烷	opfq
烹	ybou
烺	oyvy
烻	otcp
烽	otdh
焆	okeg
焉	gcqu
焊	ojfh
焌	ocmt
焐	oskg
焓	odkg
焕	oqmd
焖	ouni
焗	onsg
焘	ofyo
焙	oukg
焚	mou
焜	ojax
焞	oybg
焦	rou
焯	ohvh
焰	oqvg
焱	ooou
然	qdyo
煁	ohnn
煃	odff
煅	onxy
煊	opgg
煋	ojpg
煌	okgg
煎	uwou
煓	omdm
煜	ojug
煞	qvto
煟	oleg
煤	oafs
煦	jsou
照	jvko
煨	oley
煮	fjou
煲	mkou
煳	odeg
煴	ojlg
煸	ooma
煺	ovpy
煽	oong
熄	otni
熇	ohkg
熊	jxxo
熏	qbu
熔	oprg
熘	oqyl
熙	aylo
熛	obiy
熜	otki
熟	ybvo
熠	onkg
熥	ocep
熨	nwmo
熬	gtou
熳	ojlc
熵	oerg
熹	fako
熻	owng
燃	oqdo
燊	ooos
燋	oroy
燎	odui
燏	ocmr
燔	omlg
燕	auko
燚	oooo
燠	obod
燥	okxs
燧	ouep
燮	oyoc
燹	eueo
爆	ojri
爇	afmo
爔	ougy
爚	owxa
爝	oely
爟	oaxr
爨	wfmo
爪	ohk
爬	ohjv
爰	egdc
爱	jdcu
爵	elvy
父	mtyy
爷	mbj
爸	mjb
爹	mqu
爻	ieo
爽	diii
爿	unht
牁	uskg
牂	uph
片	sthn
版	srcy
牌	srvh
牍	sviw
牒	skds
牖	soby
牙	rte
牚	jrtr
牛	ptgh
牝	nxn
牟	cpj
牡	nfg
牢	ppj
牤	nyn
牥	npt
牦	ncnn
牧	nty
物	nqrt
牮	hypj
牯	ndg
牲	npgg
牵	dppj
特	nffy
牺	nsg
牻	ndne
牾	nskg
牿	nekg
犀	nipk
犁	tjpj
犄	ndsk
犇	pnpj
犊	nviw
犋	neuy
犍	nwfp
犏	noma
犒	nhkg
犟	xkjp
犨	rrpj
犬	dyi
犭	vtnt
犯	vln
犰	vvn
犴	vfh
状	udyy
犷	vot
犸	vcg
犹	vdnn
狁	vcqn
狂	vgg
狃	vnfg
狄	voy
狈	vmy
狉	vggg
狍	vqln
狎	vuh
狐	vocy
狒	vxjh
狗	vsg
狙	veg
狝	vqiy
狞	vpsh
狠	vvy
狡	vury
狨	vxdt
狩	vpfy
独	vjy
狭	vxwy
狮	vjkm
狯	vocy
狰	vqsh
狱	vydy
狲	vbiy
狳	vwiy
狴	vaxf
狷	vkeg
狸	vuag
狺	vyg
狻	vcmt
狼	vyvy
猁	vtjh
猃	vwqg
猄	vyiy
猇	vhnn
猊	vvqn
猎	vajg
猓	vjsy
猕	vxqi
猖	vjjg
猗	vdsk
猛	vblg
猜	vgeg
猝	vyaf
猞	vbkg
猡	vlqy
猢	vdeg
猥	vley
猩	vjpg
猪	vfjg
猫	valg
猬	vleg
献	heuy
猯	vmdm
猰	vdhd
猱	vcsy
猴	vwnc
猷	usdy
猸	vnhh
猹	vsjg
猺	verm
猾	vxg
猿	vfkk
獍	vxqn
獐	vxfh
獒	gtdy
獗	vduw
獠	vdui
獬	vqep
獭	vuqm
獯	vqby
獴	vapu
獾	vaxr
玃	vhhc
玄	aci
率	acif
玉	bggy
王	gggg
玎	gsh
玑	gnn
玒	gag
玓	gqyy
玕	gfh
玖	gqyy
玘	gln
玙	gqg
玚	gvt
玛	gcg
玞	gay
玟	gcy
玠	gwjh
玡	grtt
玢	gmvt
玤	gdhh
玥	geg
玦	gby
玩	gfqn
玫	gty
玭	gaxn
玮	gvnn
环	ggy
现	gmsn
玱	gwln
玲	gdyy
玳	ghyy
玶	gfut
玷	gvg
玹	gacy
玺	qibu
玻	ghcy
玼	gcxn
玿	gvkg
珀	gkg
珂	gskg
珅	gjhh
珇	geg
珈	gvg
珉	gnen
珊	gygg
珋	gqtb
珌	gnoy
珍	gwet
珏	gby
珐	gly
珑	gdxn
珒	gwfg
珕	glll
珖	gkn
珙	gry
珛	gefg
珝	gng
珞	gog
珠	gtsy
珢	gvy
珣	gqjg
珥	gbg
珦	gbkg
珧	giqn
珩	ghwh
珪	gffg
珫	gycq
班	gvgg
珰	givg
珲	gplh
珵	gkgg
珷	ggac
珸	gskg
珹	gpxy
珺	gvtk
珽	gqpy
琀	gdkg
球	gfy
琄	gkeg
琅	gyvy
理	guag
琇	gtet
琈	gebg
琉	gych
琊	grtb
琎	gxpy
琏	glpy
琐	gimy
琔	gpwy
琚	gndg
琛	gosy
琟	grg
琡	gmtc
琢	geuy
琤	gqsh
琥	ghnn
琦	gdsk
琨	gjax
琪	ghy
琫	gdwv
琬	gpql
琭	gjiy
琮	gpwm
琯	gpdg
琰	gooy
琲	gmxg
琳	gmy
琴	ggdb
琵	ggax
琶	ggjb
琼	gyiy
瑀	gtkc
瑁	gjhg
瑂	gnhh
瑃	gdwj
瑄	gpgg
瑅	gjwy
瑆	gjpg
瑑	gxeu
瑓	gslg
瑔	gkhi
瑕	grnc
瑖	gnxy
瑗	gegc
瑙	gvtr
瑚	gdeg
瑛	gamd
瑜	gwwh
瑝	gkgg
瑞	gmdm
瑟	ggno
瑢	gprg
瑧	gdwt
瑨	ggoj
瑬	iycb
瑭	gowk
瑰	gqcy
瑱	gfeu
瑳	gpag
瑶	germ
瑷	gjdc
瑾	gqfg
璀	gmrg
璁	gtki
璃	gybc
璆	gnwe
璇	gpwy
璈	ggty
璋	gxfh
璎	gmmv
璐	glog
璒	gwga
璘	gobh
璜	ganu
璞	goay
璟	gkiy
璠	gmlg
璥	gast
璧	dabu
璨	ghqo
璩	gheu
璪	gkxs
璬	gkpt
璮	gylg
璱	gggo
璲	guep
璺	wfmb
瓀	gfdm
瓒	geqm
瓖	gyxk
瓘	gaxr
瓜	oci
瓞	ocrw
瓠	dgwc
瓢	bioc
瓣	aoca
瓤	yxec
瓦	gni
瓮	mcgn
瓯	argn
瓴	dygn
瓶	uegn
瓷	kgnu
瓻	rdbn
瓿	ukgn
甄	sfgn
甍	alpn
甏	faen
甑	ljgn
甓	dagn
甗	hrmn
甘	afd
甙	aafd
甚	hnv
甜	qafg
生	pgd
甡	pgpg
甥	pgll
甦	gjrg
用	ehtn
甩	env
甪	tek
甫	bgh
甬	cej
甭	gej
甯	pnie
田	lhng
由	nao
甲	uhnh
申	jhk
电	jnv
男	llr
甸	qld
町	lsh
画	glbj
甾	vlf
畀	lpj
畅	jhvt
畈	lrcy
畋	lty
界	lwjj
畎	ldyy
畏	leu
畔	lvuy
畖	locy
留	qyvl
畚	cdlf
畛	lwet
畜	aclf
畤	lffy
略	log
畦	lffg
番	mlf
畬	wilf
畯	lcmt
畲	oilf
畴	lofy
畸	ldsk
畹	lpql
畿	xxxl
疁	lnwe
疃	luua
疆	xfgg
疋	wnhy
疍	wjgf
疏	ccyh
疐	fplw
疑	xccw
疒	uygg
疔	usk
疖	ubk
疗	ubk
疙	usv
疚	uqyi
疝	umk
疟	uvd
疠	ugqe
疡	uve
疢	uoi
疣	udnv
疤	ujv
疥	uwjk
疫	uxi
疬	udle
疭	uai
疮	uwlv
疯	unri
疰	ubd
疱	uqlv
疲	uhci
疳	uafd
疴	uskd
疵	ucxv
疸	ujgd
疹	uwee
疼	utui
疽	ued
疾	uci
痂	uvd
痃	uaci
痄	ukfd
病	uewi
症	ugcd
痈	uek
痉	ucad
痊	uoxd
痍	ugxw
痒	upk
痓	uad
痔	uffy
痕	uvi
痖	ugod
痘	ugad
痛	ucek
痞	ugkd
痢	utjk
痣	ufni
痤	uafd
痦	uskd
痧	uiit
痨	uapl
痪	uqmd
痫	uusi
痰	uooi
痱	umxd
痴	uckd
痹	ulpk
痼	uldd
痿	utvd
瘀	upwu
瘁	uyaf
瘃	ueuy
瘅	uulf
瘆	ucde
瘊	uwnc
瘌	uujk
瘐	uvwi
瘕	urnc
瘗	uxwf
瘘	uovd
瘙	ucuj
瘛	udhi
瘟	ujld
瘠	uiwe
瘢	uexi
瘤	uqyl
瘥	upad
瘦	uvhc
瘩	uawd
瘪	utwx
瘫	ucrd
瘭	ubii
瘰	ulxi
瘳	unwe
瘴	uxfk
瘵	uwwm
瘸	uvmi
瘼	usi
瘾	ubqi
瘿	ummv
癀	uanu
癃	ubtg
癌	ukxm
癍	ugcg
癔	uxni
癖	udak
癗	ufld
癜	unrx
癞	uuqm
癣	ucpk
癫	ufem
癯	uhhr
癸	wgdu
登	wgaf
白	kthg
百	djf
癿	knn
皂	kab
的	kqyy
皆	axkf
皇	kgf
皈	krcy
皋	kdfj
皎	kury
皑	kmln
皓	kekg
皕	djdj
皖	kpfq
皙	srkf
皛	kkkf
皞	kkdf
皤	kmlg
皦	kkpt
皭	kely
皮	hci
皱	qvhc
皲	plhc
皴	cmtc
皿	lhng
盂	fhlf
盅	slf
盆	mvlf
盈	eclf
盉	tlf
益	uulf
盍	llf
盎	mdlf
盏	gxlf
盐	fhlf
监	jlf
盒	wlf
盔	dolf
盖	uglf
盗	klf
盘	elf
盛	pxyl
盟	jelf
盥	shil
盦	dslf
目	hhng
盯	hsh
盱	hfhh
盲	yhf
直	fef
盷	hqug
相	tghg
盹	hban
盼	hmvt
盾	rfhd
省	ithf
眄	hgch
眇	hitt
眈	hpsn
眉	nhhd
眊	hcnn
看	medd
眍	hary
眙	hckg
眚	pghf
真	feuu
眠	hnen
眢	qlhf
眦	hcxn
眨	htpy
眩	hacy
眬	hdxn
眭	hffg
眯	hoy
眵	hqy
眶	hagg
眷	xhf
眸	hcph
眺	hiqn
眼	hvy
着	phd
睁	hqsh
睃	hcmt
睄	hieg
睇	huxt
睎	hrdb
睐	hxiy
睑	hwqg
睚	hdff
睛	hgeg
睡	hqag
睢	hrg
督	mtch
睥	hrvh
睦	hfmf
睨	hvqn
睫	hgvc
睬	hesy
睹	hfjg
睽	hwgd
睾	tlff
睿	hpgh
瞀	cthf
瞄	halg
瞅	htoy
瞋	hfeu
瞌	hllg
瞍	hvhc
瞎	hjrg
瞑	hpju
瞒	haea
瞟	hbiy
瞠	hjfg
瞢	alph
瞥	othf
瞧	hroy
瞩	hntc
瞪	hwga
瞫	hsvh
瞬	hjbh
瞭	hdui
瞰	hnbt
瞳	huua
瞵	hobh
瞻	hqdy
瞽	fafh
瞿	hhrf
矍	hhrc
矗	fefe
矛	cnyt
矜	cdn
矞	cmrf
矢	ctgy
矣	ccu
知	ckg
矧	cxhh
矩	cang
矫	cmjh
矬	cafg
短	cgag
矮	ctvg
矰	cljg
石	dddd
矶	dnn
矸	dfh
矻	dsn
矼	dag
矽	dqy
矾	dny
矿	dot
砀	dvt
码	dcg
砂	ditt
砄	dby
砆	day
砉	dhdf
砌	davt
砍	dqwy
砑	drtt
砒	daxn
研	deh
砖	dvcy
砗	dlh
砘	dban
砚	dmsn
砜	dnry
砝	dly
砟	dkfg
砠	deg
砣	dpxn
砥	dscy
砦	cxdf
砧	dvg
砩	dxjh
砫	dbg
砬	dug
砭	dtpy
砮	vcdf
砰	dfut
破	dhcy
砵	djg
砷	djhh
砸	dabh
砹	dary
砺	ddqt
砻	dxdf
砼	dwag
砾	dqiy
础	dbmh
硁	dcag
硅	dffg
硇	dtkr
硊	dqdl
硌	dog
硍	dvy
硎	dejh
硐	dmg
硒	dsg
硔	dry
硕	ddmy
硖	dxwy
硗	dxpn
硙	dmln
硚	dmjh
硝	dieg
硪	dryy
硫	dych
硬	dgjr
硭	dayn
确	dqeh
硷	dwqg
硼	deeg
硿	dpsg
碃	dgeg
碇	dpwy
碈	dsnj
碉	dmfk
碌	djiy
碍	dxhh
碎	dyaf
碏	dajg
碑	drvh
碓	drg
碗	dpql
碘	dmry
碚	dukg
碛	dgmy
碜	dcde
碟	dkds
碡	dgxs
碣	djqn
碥	doma
碧	gkdf
碨	dley
碰	duog
碱	ddry
碲	dupb
碳	dmdo
碴	dsjg
碶	ddhd
碹	dpgg
碾	dnae
磁	duoy
磅	dupp
磉	dcos
磊	dddf
磋	dpag
磏	duvo
磐	exdf
磔	dbsy
磕	dllg
磙	duck
磜	dwwm
磡	dhnl
磨	vdd
磬	fnhd
磲	dias
磴	dwga
磷	dobh
磹	dsvh
磺	danu
磻	dmlg
礁	droy
礅	dybt
礌	dflg
礓	dglg
礞	dapu
礤	dawm
礴	daiy
礵	dftg
示	wmi
礻	oyny
礼	onn
社	ofg
祀	oln
祁	obh
祃	ocg
祆	ogdy
祇	osnn
祈	orh
祉	ocg
祊	opt
祋	oxy
祎	ovnn
祏	odg
祐	otrg
祓	odcy
祕	onoy
祖	oeg
祗	oscy
祚	okfg
祛	oly
祜	odg
祝	okqn
神	ojhh
祟	bmwm
祠	onrg
祢	oqiy
祥	oph
祧	oiqn
票	biu
祭	wwmu
祯	ohmy
祲	ovpc
祷	oofy
祸	okmw
祺	ohy
祼	ojsy
祾	ofmt
禀	ylkm
禁	mwmu
禄	ojiy
禅	oulf
禊	odhd
禋	osfg
福	orlg
禒	oxeu
禔	ojwy
禘	oupb
禚	ougo
禛	ofeu
禤	olng
禧	ofak
禳	oyxk
禹	tkmc
禺	jmci
离	ybmc
禽	wybc
禾	tttt
秀	ter
私	tcy
秃	tnb
秆	tfh
秉	tvd
秋	toy
种	tsh
科	twh
秒	titt
秕	taxn
秘	tnoy
租	teg
秣	tgsy
秤	tfut
秦	dwtu
秧	tmdy
秩	trwy
秫	tsyy
秬	tang
秭	ttnt
积	tkuy
称	tqiy
秸	tfkg
移	tqy
秽	tmqy
秾	tpky
稀	trdb
稂	tyvy
稃	tebg
稆	tkkg
程	tkgg
稌	twiy
稍	tieg
税	tdqn
稑	tfmf
稔	tdni
稗	trvh
稙	tfeg
稚	trg
稞	tjsy
稠	tmfk
稣	cty
稳	tqvi
稷	tlmt
稹	tfeu
稻	tevg
稼	tpeu
稽	tdnj
稿	thkg
穄	twwm
穆	tkie
穑	tfuk
穗	tgji
穙	toay
穜	tuua
穟	tuep
穰	tyxk
穴	pyyy
究	pvb
穷	plr
穸	pqu
穹	pxb
空	psf
穿	prtr
窀	pbab
突	pdyu
窃	pavr
窄	pkff
窅	phf
窆	ptpu
窈	pxlr
窊	pocu
窍	pawb
窎	pqgf
窑	prmj
窒	paf
窕	piqb
窖	pekf
窗	ptkt
窘	pvtk
窜	pskf
窝	pkmw
窟	pnbm
窠	pjsu
窣	pyaf
窥	pams
窦	pviw
窨	pxf
窬	pwwj
窭	povf
窳	pocc
窸	pmni
窿	pbtg
立	uuuu
竑	udcy
竖	tuf
竘	usg
站	uvg
竞	ukqb
竟	xqb
章	xfj
竣	ucmt
童	uuaf
竦	uuy
竫	uqsh
竭	ujqn
端	umdm
竹	ttgh
竺	tff
竽	tfhj
竿	tfj
笃	tcf
笄	tej
笆	tjb
笈	teyu
笊	tohj
笋	tvtr
笏	tqrr
笑	tmyu
笔	tcnb
笕	tmsb
笙	tpgf
笛	tnf
笞	tckf
笠	tuf
笤	tvkf
笥	tnrf
符	twfy
笨	tjf
笪	tjgf
笫	ttnt
第	txr
笮	tkff
笯	tvcu
笱	tsf
笳	tvf
笸	takf
笺	tgxu
笼	tdxb
笾	tlpu
筀	tfff
筅	teqb
筇	tabj
等	tffy
筋	telr
筌	toxf
筏	twxu
筐	tagf
筑	tanu
筒	tmf
答	twf
策	teiu
筘	trkf
筚	taxf
筛	tjkm
筜	tivf
筝	tqsj
筠	tfqu
筢	trjb
筤	tyvu
筥	tkkf
筦	tpfq
筮	taau
筱	twht
筲	tief
筵	ttcp
筶	tekf
筷	tnbu
筹	tofy
筻	tgjr
筼	tkmu
签	twqf
简	tujf
箅	tlpj
箍	trab
箐	tgef
箓	tjiu
箔	tikf
箕	thu
箖	tmu
算	thaj
箜	tpsf
箝	traf
管	tpdf
箢	tpql
箦	tgmu
箧	taxw
箨	trcv
箩	tlqu
箪	tulf
箫	tvij
箬	tatr
箭	tuwj
箱	ttf
箴	tdry
箸	tfjf
篁	tkgf
篆	txeu
篇	toma
篌	twnc
篑	txmu
篓	tovf
篙	thkf
篚	tamx
篝	temf
篡	thdc
篥	tssu
篦	ttkx
篪	trhn
篮	tjlf
篯	tqgx
篱	tybc
篷	ttdp
篼	tqkq
篾	tldy
簃	ttqu
簇	tpcu
簉	tekp
簋	tvlf
簌	tuqw
簏	tsxb
簕	tqlr
簖	tonr
簝	tdui
簟	tsvj
簠	tblf
簦	twga
簧	tanu
簪	tlsj
簰	tsrv
簸	thhc
簿	tiby
籀	trql
籁	tuqm
籍	tdij
籥	twxa
米	oao
籴	tyou
类	odu
籼	omh
籽	obg
粉	omvt
粑	ojn
粒	oug
粕	okg
粗	oeg
粘	ovg
粜	bmou
粝	odqt
粞	osg
粟	sou
粢	kou
粤	tkow
粥	xoxn
粪	oru
粮	oyvy
粱	ivmo
粲	hqco
粳	ogjr
粹	oyaf
粼	obbn
粽	opwm
精	ogeg
粿	ojsy
糁	ocde
糅	ocsy
糇	ownc
糈	oweg
糊	odeg
糌	othj
糍	ouoy
糒	oate
糕	ougo
糖	oowk
糗	otdy
糙	oekp
糜	voi
糟	oemj
糠	oowi
糨	oxkj
糯	ofdm
糵	atdo
糸	xiu
系	txiu
紊	cxiu
素	gxiu
索	fpxi
紧	txiu
紫	cxxi
累	lxiu
絜	dhvi
絮	vkxi
絷	hxiu
綦	hxiu
綮	otxi
縠	fpgx
縢	exxi
縻	vxii
繁	xtxi
繄	acxi
繇	ermi
纂	thdi
纛	gxsi
纟	xnng
纠	xnhh
纡	xfhh
红	xag
纣	xfyy
纤	xqh
纥	xsn
约	xqyy
级	xeyy
纨	xvyy
纩	xot
纪	xln
纫	xvyy
纬	xvnn
纭	xcy
纮	xdcy
纯	xban
纰	xaxn
纱	xitt
纲	xmry
纳	xmwy
纴	xqg
纵	xay
纶	xwxn
纷	xmvt
纸	xsnn
纹	xcy
纺	xpt
纻	xpgg
纼	xxhh
纽	xnfg
纾	xcsh
线	xgxy
绀	xafg
绁	xkdg
绂	xdcy
练	xaiy
组	xeg
绅	xjhh
细	xlg
织	xkuy
终	xtuy
绉	xqvg
绊	xvuy
绋	xxjh
绌	xbmh
绍	xvkg
绎	xcvh
经	xcag
绐	xckg
绑	xobh
绒	xxdt
结	xfkg
绔	xdgw
绕	xxpn
绖	xag
绗	xhwh
绘	xocy
给	xwg
绚	xqjg
绛	xtah
络	xog
绝	xqjn
绞	xury
统	xycq
绠	xgjr
绡	xieg
绢	xkeg
绣	xtet
绤	xmrg
绥	xevg
绦	xtiy
继	xonn
绨	xuxt
绩	xgmy
绪	xfjg
绫	xfmt
续	xviw
绮	xdsk
绯	xmxg
绰	xhvh
绱	xjg
绲	xjax
绳	xkjn
维	xrg
绵	xkbh
绶	xjcy
绷	xeeg
绸	xmfk
绹	xqrm
绺	xthk
绻	xxln
综	xpwm
绽	xpwy
绾	xpdg
绿	xjiy
缀	xooy
缁	xvlg
缂	xqh
缃	xtg
缄	xdry
缅	xdlf
缆	xjms
缇	xjwy
缈	xhit
缉	xkbg
缊	xjlg
缋	xxmy
缌	xlni
缍	xqag
缎	xnxy
缏	xwgr
缐	xkhi
缑	xwnc
缒	xtdp
缓	xegc
缔	xupb
缕	xovg
编	xoma
缗	xnej
缘	xxeu
缙	xgoj
缚	xbfy
缛	xdey
缜	xfeu
缝	xtdp
缞	xygk
缟	xhkg
缠	xoua
缡	xybc
缢	xuul
缣	xuvo
缤	xpru
缥	xbiy
缦	xjlc
缧	xlxi
缨	xmmv
缩	xpwj
缪	xnwe
缫	xvjs
缬	xfkm
缭	xdui
缮	xpur
缯	xljg
缰	xglg
缱	xxdp
缲	xkxs
缳	xlrk
缴	xkpt
缵	xeqm
缶	rmk
缸	rmag
缺	rmby
罂	mmrm
罄	fnhm
罅	rmhh
罍	lllm
罐	rmar
网	mdi
罔	muyv
罕	ofj
罗	lqu
罘	lgu
罚	lyjj
罟	ldf
罡	lgcf
罢	llu
罨	ldjn
罩	lhvj
罪	lmxf
置	lfef
罱	lhef
署	lfjf
罴	llou
罶	lqyl
罹	lnrf
罽	ldoj
罾	lljf
羁	lqcf
羊	pyth
羌	pnv
美	ugdu
羑	ugqy
羓	pjn
羔	ugou
羕	ugyn
羖	pxy
羚	pdyy
羝	pscy
羞	pnfd
羟	pcag
羡	ugku
群	vtkp
羧	pcmt
羯	pjqn
羰	pmdo
羱	pdki
羲	ugty
羸	yepn
羹	ugod
羼	nppp
羽	neo
羿	naj
翀	nsh
翁	mcnf
翂	nmvt
翃	dcng
翅	fcnd
翈	ung
翊	ung
翌	nuf
翎	dyng
翔	png
翕	wnf
翘	xpnd
翙	mqng
翚	nplj
翛	whtn
翟	nrf
翠	nyaf
翡	mxnf
翥	fjnf
翦	uwnf
翩	oman
翮	rmun
翯	nhkf
翰	kwng
翱	kdfn
翳	acxn
翷	obng
翻	mlng
翼	nlru
翾	lrkn
耀	knrg
老	fxv
考	fwv
耄	fxcn
者	fjd
耆	fxjf
耇	fsd
耋	fxaf
而	dmj
耍	dmvf
耏	dmet
耐	dmfy
耑	mdmj
耒	dii
耔	dibg
耕	dixh
耖	diit
耗	dicn
耘	dicy
耙	dijn
耜	didg
耠	diwg
耢	dial
耤	diaj
耥	dijg
耦	dijc
耧	diov
耨	didy
耩	dief
耪	diup
耰	didt
耱	divd
耳	bghg
耵	bsh
耶	bbh
耷	dbf
耸	abf
耻	bcg
耽	bpsn
耿	boy
聂	bou
聃	bmfg
聆	bdyy
聊	bqtb
聋	dxbf
职	bkuy
聍	bpsh
聒	bqg
联	bsy
聘	bnwn
聚	bcwi
聩	bxmy
聪	bdni
聱	gtbf
聿	wfd
肀	wngh
肃	vijk
肄	xcwf
肆	vwfg
肇	otwf
肉	mii
肋	elt
肌	enn
肓	yef
肖	ief
肘	efyy
肚	efg
肛	eag
肜	eet
肝	efh
肟	egwn
肠	evt
股	exy
肢	efcy
肤	eay
肥	ejn
肩	oed
肪	ept
肫	eban
肭	emwy
肮	eynn
肯	cef
肱	edcy
育	ycef
肴	reff
肷	eqwy
肸	emfh
肺	egbh
肼	exh
肽	eduy
肾	tef
肿	esh
胀	ehsy
胁	elmy
胂	ejhh
胃	lef
胄	nef
胆	ejgg
胈	edcy
背	uxef
胍	eocy
胎	eckg
胖	evuy
胗	ewet
胙	ekfg
胚	eggg
胛	euh
胜	epgg
胝	escy
胞	eqln
胠	ely
胡	deg
胣	etmn
胤	txen
胥	wef
胧	edxn
胨	eaiy
胩	emy
胪	ehnt
胫	ecag
胬	vcmi
胭	eldy
胯	edgw
胰	egxw
胱	ekn
胲	eaoy
胳	eog
胴	emg
胶	eury
胸	eqbh
胺	epvg
胼	eueh
能	jxxn
脂	exjg
脆	eqdl
脉	eyin
脊	iwef
脍	eocy
脎	ejy
脏	eofg
脐	ecjh
脑	eybh
脒	eoy
脓	epky
脔	pmiu
脖	efpb
脘	epfq
脚	elbh
脞	eafg
脟	eefy
脩	whte
脬	eebg
脯	eby
脱	edqn
脲	enhi
脶	ekmw
脸	ewqg
脾	ervh
脿	egky
腆	emry
腈	egeg
腊	eajg
腋	eywy
腌	edjn
腐	owfi
腑	eowy
腒	endg
腓	emxg
腔	epsg
腕	epql
腘	elby
腙	epwm
腚	epwy
腠	edwd
腥	ejpg
腧	ewwh
腨	emdm
腩	ehef
腭	exgw
腮	elni
腯	erfh
腰	esvg
腱	ewfp
腴	evwy
腹	etjt
腺	ekhi
腻	eafm
腼	edlf
腽	ejlg
腾	excg
腿	evpy
膀	eupp
膂	pque
膈	ermh
膊	ebfy
膏	hkef
膑	epru
膘	ebiy
膙	exkj
膛	ejfg
膜	esy
膝	eswi
膣	epag
膦	eobh
膨	efae
膪	eupk
膳	epur
膺	owre
膻	eylg
臀	nrxe
臁	eouo
臂	daef
臃	eyxr
臆	exni
臊	ekxs
臌	efac
臑	efdm
臜	eeqm
臣	ayk
臧	uayy
自	tthg
臬	tsu
臭	tdyu
至	agng
致	aty
臻	adwt
臼	vthg
臾	vwi
舀	evf
舁	vaj
舂	dwvf
舄	vqou
舅	vllr
舆	wflu
舌	qtgg
舍	bkf
舐	qsnn
舒	bkcs
舔	qgdy
舛	btnh
舜	jbj
舞	rlgb
舟	etty
舠	evt
舡	eag
舢	emh
舣	eyry
舥	ejn
舨	ercy
航	eynn
舫	ept
般	exy
舭	eaxn
舯	esh
舰	emsn
舱	ewln
舲	edyy
舳	eng
舴	ekfg
舵	epxn
舶	ekg
舷	eacy
舸	eskg
船	enkg
舻	ehnt
舾	esg
艄	eieg
艅	ewiy
艇	eqpy
艉	encn
艋	eblg
艎	ekgg
艏	eqg
艘	evhc
艚	eemj
艟	euua
艨	eapu
艮	vngy
良	yvu
艰	cvy
色	qjb
艳	dhqj
艴	xjqj
艹	aghh
艺	anb
艽	avb
艾	aru
艿	aer
节	abj
芃	anu
芄	avyu
芈	ghhv
芊	aqj
芋	afhj
芍	aqyu
芎	axb
芏	aff
芑	alb
芒	ayb
芗	axtr
芘	aaxb
芙	aau
芜	afsb
芝	apu
芟	axu
芠	acu
芡	aqwu
芣	agu
芤	abnb
芥	awjj
芦	aor
芨	aeyu
芩	adb
芪	asnb
芫	afqb
芬	amvr
芭	ajb
芮	amwu
芯	aniu
芰	afcu
花	ahb
芳	apr
芴	aqrr
芷	acf
芸	acu
芹	arj
芼	acnb
芽	artr
芾	agbj
苁	aau
苄	ayhu
苇	avnb
苈	adlr
苉	aaqb
苊	adlb
苋	amsb
苌	ahsu
苍	awlb
苎	apgf
苏	almu
苑	aqlb
苒	amff
苓	adyu
苔	ackf
苕	avkf
苗	alf
苘	amkf
苛	askf
苜	ahf
苞	aqlb
苟	asf
苠	aneb
苡	anwu
苣	aanf
苤	aggf
若	atrf
苦	adf
苧	apsj
苫	avf
苯	ajf
英	amdu
苴	aef
苷	aaff
苹	afur
苻	awfy
苾	anou
茀	axjj
茁	abmj
茂	adxy
范	ailb
茄	avf
茅	acr
茆	aqtb
茇	adcu
茈	acxb
茉	agsu
茋	ascu
茌	awff
茎	acaf
茏	adxb
茑	aqgf
茓	apu
茔	apff
茕	apnf
茗	aqkf
茚	asbj
茛	avu
茜	asf
茝	aayj
茧	aju
茨	aku
茫	aiyb
茬	adjf
茭	auru
茯	awdy
茱	atsu
茳	aiaf
茴	alkf
茵	aldu
茶	awiu
茸	abf
茹	avkf
茺	aycq
茼	amf
茽	awsj
荀	aqjf
荁	agjg
荃	aoxf
荄	aaou
荆	aejh
荇	ahwj
草	avj
荏	awqf
荐	adhb
荑	agxw
荒	ayqh
荓	auej
荔	alll
荖	afxb
荙	adpu
荚	axwu
荛	axpb
荜	aaxf
荞	amjj
荟	aocu
荠	acjj
荡	aivr
荣	apsu
荤	aplj
荥	aphi
荦	appj
荧	apou
荨	avfy
荩	anmu
荪	abiu
荫	abef
荬	aciw
荭	axaf
荮	axfy
药	axqy
荷	awsk
荸	afpb
荻	avou
荼	awiu
荽	aevf
莅	awuf
莆	abu
莉	atjj
莎	aiit
莒	akkf
莓	axu
莘	aaj
莙	avtk
莛	aqpu
莜	awht
莝	aaff
莞	apfq
莠	ater
莨	ayvu
莩	aebf
莪	aryu
莫	sghy
莰	afqw
莱	axiu
莲	alpu
莳	ajfy
莴	akmw
莶	awqf
获	avdy
莸	avdn
莹	apbu
莺	apqg
莼	axba
莽	adya
莿	aeij
菀	apql
菁	agef
菂	akqy
菅	apdf
菇	avdf
菉	ajiu
菊	aqou
菌	altu
菍	adni
菏	aisk
菔	aeiu
菖	ajjf
菘	asmc
菜	aesu
菝	ardc
菟	alsy
菠	aihc
菡	abib
菥	asrj
菩	aukf
菪	apdf
菰	aboc
菱	afmt
菲	amxf
菸	apwu
菹	aief
菼	aoou
菽	amtc
萁	ahu
萃	ayaf
萄	aqrm
萆	arvj
萋	agwv
萌	ajef
萍	aifu
萎	atvf
萏	aqvf
萑	arf
萘	adwm
萚	arcv
萜	abvf
萝	alqu
萣	apwu
萤	apju
营	apkk
萦	apxi
萧	avij
萨	abut
萩	atou
萱	apgg
萳	ahef
萸	avwu
萹	aoma
萼	axgw
落	aiof
葆	amkf
葎	ahwf
葑	affy
葖	apdy
著	afjf
葙	atf
葚	ahnb
葛	ajqn
葜	adhd
葡	aqbu
董	aqua
葩	akjb
葫	adef
葬	abxa
葭	arnc
葰	awct
葱	aqri
葳	advy
葴	adry
葵	awgd
葶	ahsj
葸	alni
葺	akbf
蒂	aupb
蒄	apfy
蒇	admy
蒈	aaxk
蒉	axmu
蒋	auqy
蒌	aovf
蒎	airu
蒐	aqcu
蒗	aiyv
蒙	apgu
蒜	awmm
蒟	ausf
蒡	aupp
蒨	awge
蒯	aeej
蒱	arbu
蒲	aibu
蒴	aube
蒸	abio
蒹	auvo
蒺	aucu
蒻	axuu
蒽	aldi
蒿	ahkf
蓁	adwt
蓂	apju
蓄	aacl
蓇	axf
蓉	aprf
蓊	amcn
蓍	afxj
蓏	aocc
蓐	adey
蓑	aygk
蓓	awuk
蓖	atkx
蓝	ajlf
蓟	acjj
蓠	aybc
蓢	ayve
蓣	acsm
蓥	apbu
蓦	scf
蓬	atdp
蓰	ahcc
蓼	anwe
蓿	apwj
蔀	aukb
蔃	axkj
蔈	abiu
蔊	aojf
蔌	auqw
蔑	aldy
蔓	ajlc
蔗	alou
蔚	anwy
蔟	apcu
蔡	awwm
蔫	agcq
蔬	acch
蔷	afuk
蔸	aqkq
蔹	awqt
蔺	aurf
蔻	apfc
蔼	ayjn
蔽	aotu
蕃	amlf
蕈	asvj
蕉	arou
蕊	anii
蕖	aias
蕗	alof
蕙	agji
蕞	ajbc
蕤	aeug
蕨	aduw
蕰	aijl
蕲	aulr
蕴	axjl
蕹	ayxr
蕺	akby
蕻	avru
蕾	aflf
薁	abod
薄	aiby
薅	avdy
薇	ahmt
薏	axni
薛	atda
薜	adaj
薢	aqep
薤	abmg
薨	alpx
薪	auir
薮	aovt
薯	alfj
薰	aqbu
薳	afkp
薷	afdm
薸	aibi
薹	afka
薿	axcw
藁	ahks
藉	adij
藏	auay
藐	aekq
藓	acpj
藕	adic
藜	atqi
藟	alll
藠	akkk
藤	aexi
藦	avch
藨	asxo
藩	aiml
藻	aiks
藿	afrf
蘅	ahcw
蘑	avdf
蘖	atds
蘘	ayxk
蘧	ahep
蘩	axti
蘸	asro
蘼	avmx
虍	hhgn
虎	hnv
虏	hle
虐	hvd
虑	hnii
虒	rhnv
虓	vhnn
虔	hci
虚	hod
虞	hkgd
虢	efyn
虤	hnhn
虫	jhny
虬	jnn
虮	jnn
虱	ntji
虷	jfh
虸	jbg
虹	jag
虺	pji
虻	jyn
虼	jsn
虽	kju
虾	jghy
虿	gqju
蚀	hjy
蚁	jyry
蚂	jcg
蚄	jpt
蚆	jjn
蚊	jcy
蚋	jmwy
蚌	jdhh
蚍	jaxn
蚓	jxhh
蚕	gdju
蚜	jrtt
蚝	jcnn
蚣	jmcy
蚤	cuju
蚧	jwjh
蚨	jay
蚩	bgju
蚪	jwh
蚬	jmsn
蚯	jrgg
蚰	jng
蚱	jkfg
蚲	jfut
蚴	jxlt
蚵	jskg
蚶	jafg
蚺	jmfg
蛀	jbg
蛃	jewy
蛄	jdg
蛆	jeg
蛇	jpxn
蛉	jdyy
蛊	jlf
蛋	wju
蛎	jdqt
蛏	jcfg
蛐	jkah
蛑	jcph
蛔	jlkg
蛘	jph
蛙	jffg
蛛	jtsy
蛞	jqg
蛟	jury
蛤	jwg
蛩	anju
蛭	jag
蛮	pju
蛰	hju
蛱	jxwy
蛲	jxpn
蛳	jjkm
蛴	jcjh
蛸	jieg
蛹	jceh
蛾	jryy
蜀	lqju
蜂	jtdh
蜃	deji
蜇	rrju
蜈	jkgd
蜉	jebg
蜊	jtjh
蜍	jwiy
蜎	jkeg
蜐	jllt
蜒	jtcp
蜓	jqpy
蜕	jdqn
蜗	jkmw
蜘	jckg
蜚	mxju
蜜	pnoj
蜞	jhy
蜡	jajg
蜢	jblg
蜣	jpnn
蜥	jsrh
蜩	jmfk
蜮	jxkg
蜱	jrvh
蜴	jjqr
蜷	jxln
蜻	jgeg
蜾	jjsy
蜿	jpql
蝇	jkjn
蝈	jlby
蝉	julf
蝌	jtwh
蝎	jjqn
蝓	jwwh
蝗	jkgg
蝘	jajv
蝙	joma
蝠	jrlg
蝣	jpbg
蝤	jusg
蝥	ctju
蝮	jtjt
蝰	jdff
蝲	jujh
蝴	jdeg
蝶	jkds
蝻	jhef
蝼	jovg
蝽	jdwj
蝾	japs
螂	jyvb
螃	jupp
螅	jtni
螈	jdki
螋	jvhc
融	rmuj
螓	jdwt
螗	jowk
螟	jpju
螠	juul
螣	exjy
螨	jaea
螫	fotj
螬	jemj
螭	jybc
螯	gtju
螱	nwmj
螳	jjfg
螵	jbiy
螺	jlxi
螽	tujj
蟀	jacf
蟆	jsy
蟊	cjju
蟋	jmni
蟏	javj
蟑	jxfh
蟒	jada
蟓	jleu
蟛	jfae
蟠	jmlg
蟥	janu
蟪	jgji
蟫	jsvh
蟮	jpur
蟹	qevj
蟾	jqdy
蠃	yejn
蠊	jouo
蠋	jlqj
蠓	japu
蠕	jfdm
蠖	jarc
蠛	jaly
蠡	xeuj
蠢	dwjj
蠲	uulj
蠹	npdj
蠼	jhhc
血	tld
衃	tlgy
衄	tlnf
衅	tlvu
行	hwh
衍	hiwh
衎	hfwh
衒	hacw
衔	hqwh
街	hffw
衙	hskw
衠	hfew
衡	hcww
衢	hhhw
衣	yku
衤	bynh
补	bhy
表	gku
衩	bcuy
衫	bet
衬	bfyy
衮	ucku
衰	ygku
衲	bmwy
衷	vkku
衽	bqg
衾	dyku
衿	bdn
袁	fkku
袂	bby
袄	bmyy
袅	qyki
袆	bvnn
袈	vyku
袋	hyyk
袍	bqln
袒	bjgg
袖	bng
袗	bwet
袜	bgsy
袢	bvuy
袤	ycku
袪	bly
被	bhcy
袭	dxyk
袯	bhdc
袱	bwdy
袷	bwg
袼	bog
裁	jyki
裂	bjyk
装	ufyk
裆	bivg
裈	bplh
裉	bvy
裎	bkgg
裒	yvku
裔	ykmr
裕	bmrg
裘	fyku
裙	bvtk
裛	yjku
裟	iitk
裢	blpy
裣	bwqg
裤	bolh
裥	bujg
裨	brvh
裰	booy
裱	bgky
裳	jyku
裴	mxyk
裸	bjsy
裹	yjsk
裼	bjqr
裾	bndg
褂	bffh
褊	boma
褐	bjqn
褒	ymkk
褓	bmkg
褕	bwwh
褙	buxe
褚	bfjg
褛	bovg
褟	bjng
褡	bawg
褥	bdey
褪	bvpy
褫	brhn
褯	blbh
褰	pyku
褴	bjlg
褶	bnkg
襁	bxkj
襄	yxek
襕	busl
襚	buep
襜	bqdy
襞	dayk
襟	bmwm
襦	bfdm
襫	bddj
襻	bmih
西	sghg
要	svf
覃	svj
覆	shtt
见	msb
观	cmsn
觃	msbd
规	amsn
觅	emsb
视	omsn
觇	vmsn
览	jmsb
觉	imsb
觊	mlms
觋	aams
觌	viws
觎	wwms
觏	emfs
觐	qfms
觑	homs
角	qej
觖	qeby
觚	qeoc
觜	cxqe
觞	qetv
觟	qeff
解	qevp
觥	qekn
触	qejy
觫	qeuy
觭	qedk
觯	qeuf
觱	drxe
觳	fpgx
觿	qemr
言	yyyy
訄	vyd
訇	qyd
訚	uyd
訾	cxyf
詈	lyf
詟	dxyf
詹	qdmy
誉	cyf
誊	xyf
誓	rryf
謇	pyf
謦	fnhy
警	asty
譬	dayf
讠	yyn
计	yfh
订	ysh
讣	yhy
认	ywy
讥	ynn
讦	yfh
讧	yag
讨	yfyy
让	yhg
讪	ymh
讫	ysn
训	yjh
议	yyry
讯	ynfh
记	yln
讱	yvyy
讲	yxh
讳	yvnn
讴	yary
讵	yang
讶	yrtt
讷	ymwy
许	yrhh
讹	yhn
论	ywxn
讻	ybh
讼	ymcy
讽	ynry
设	yxy
访	ypt
诀	yby
证	ygcg
诂	ydg
诃	yskg
评	yfut
诅	yeg
识	ykuy
诇	ymkg
诈	ykfg
诉	yryy
诊	ywet
诋	yscy
诌	yqvg
词	ynrg
诎	ybmh
诏	yvkg
诐	yhcy
译	ycvh
诒	yckg
诓	yagg
诔	ydiy
试	yaag
诖	yffg
诗	yffy
诘	yfkg
诙	ydoy
诚	ypxy
诛	ytsy
诜	yeqn
话	yqg
诞	ytcp
诟	yfkg
诠	yoxg
诡	yqdl
询	yqjg
诣	yxjg
诤	yqsh
该	yaoy
详	yph
诧	ypmn
诨	yplh
诩	yng
诫	yxah
诬	yaay
语	yskg
诮	yieg
误	ykgd
诰	yekg
诱	ytet
诲	yxy
诳	yvgg
说	ydqn
诵	yceh
诶	yccy
请	ygeg
诸	yfjg
诹	ybcy
诺	yatr
读	yviw
诼	yeuy
诽	ymxg
课	yjsy
诿	ytvg
谀	yvwy
谁	yrg
谂	ydni
调	ymfk
谄	yqvg
谅	yyiy
谆	yybg
谇	yyaf
谈	yooy
谊	ypeg
谋	yafs
谌	yhnn
谍	ykds
谎	yayh
谏	yslg
谐	yaxk
谑	yhvg
谒	yjqn
谓	yleg
谔	yxgw
谕	ywwh
谖	yegc
谗	ylsu
谘	ykkg
谙	yxg
谚	yute
谛	yupb
谜	yopy
谝	yoma
谞	yweg
谟	ysy
谠	yjqn
谡	ylmt
谢	yyfy
谣	yerm
谤	yupp
谥	yuul
谦	yuvo
谧	ynol
谨	yqfg
谩	yjlc
谪	yedg
谫	yuwv
谬	ynwe
谭	ysvh
谮	ylsj
谯	yroy
谰	yusl
谱	yuoj
谲	ycmr
谳	yhey
谴	yxdp
谵	yqdy
谶	yaxg
谷	mrf
谼	mrry
谿	exdr
豁	jrmr
豆	gaf
豇	gaag
豉	gafc
豌	gapl
豕	eui
豚	eeuy
象	leui
豢	xeuu
豨	eurb
豪	heuu
豫	cslu
豮	eufm
豳	eumu
豸	etyt
豹	eqyy
豺	eftt
貂	evkg
貅	ewsy
貆	egjg
貉	eog
貊	edjg
貌	ekqn
貔	etkx
貘	esy
贝	mhny
贞	hmu
负	qmu
贡	amu
财	mftt
责	gmu
贤	tmu
败	mty
账	mhsy
货	hmu
质	rfmi
贩	mrcy
贪	dmu
贫	mvmu
贬	mtpy
购	mqcy
贮	mpgg
贯	xfmu
贰	afmi
贱	mgxy
贲	famu
贳	kdmu
贴	mvg
贵	xmu
贶	mkqn
贷	hymu
贸	qyvm
费	xjmu
贺	vmu
贻	mckg
贼	mxdt
贽	hmu
贾	smu
贿	mefg
赀	cxmu
赁	wqmu
赂	mog
赃	mofg
资	kmu
赅	maoy
赆	mnmu
赇	mfy
赈	mdey
赉	ximu
赊	moiy
赋	mgac
赌	mfjg
赍	fapm
赎	mviw
赏	jmu
赐	mjqr
赑	mmmu
赒	mmfk
赓	ovwm
赔	mukg
赕	mooy
赖	uqmy
赗	mjhg
赘	gtmu
赙	mbfy
赚	muvo
赛	pmu
赜	aygm
赝	dwrm
赞	eqem
赟	cgam
赠	mljg
赡	mqdy
赢	yemn
赣	xftm
赤	fou
赦	foty
赧	foiy
赪	fohm
赫	fofo
赭	fofj
走	kghy
赳	knhk
赴	khi
赵	kri
赶	kfk
起	klv
趁	kwee
趄	ked
超	kvkd
越	kaxy
趋	kqvd
趑	kki
趔	kbjk
趟	kjd
趣	kbci
趯	knrd
趱	keqm
足	lhny
趴	lmy
趵	lqyy
趸	gqlu
趺	lay
趼	leh
趾	lcg
趿	leyy
跂	lfcy
跃	lmyy
跄	lwln
跆	lckg
跋	ldcy
跌	lrwy
跎	lpxn
跏	lvg
跐	lcxn
跑	lqln
跖	ldg
跗	lwfy
跚	lygg
跛	lhcy
距	lang
跞	lqiy
跟	lvy
跣	leqn
跤	lury
跨	ldgw
跪	lqdl
跫	anlu
跬	lffg
路	log
跱	lffy
跳	liqn
践	lgxy
跶	ldpy
跷	lxpn
跸	laxf
跹	lqpy
跺	lnsy
跻	lcjh
跽	llni
踅	rrlu
踉	lyvy
踊	lceh
踌	lofy
踏	lhij
踒	ltvg
踔	lhvh
踝	ljsy
踞	lndg
踟	lckg
踢	ljqr
踣	lukg
踦	ldsk
踩	lesy
踪	lpwm
踬	lrfm
踮	lokg
踯	lsbh
踱	llcy
踵	lqua
踶	ljwy
踹	lmdm
踺	lwfp
踽	ltkc
蹀	lkds
蹁	loma
蹂	lcsy
蹄	lupb
蹅	lsjg
蹇	plu
蹈	levg
蹉	lpag
蹊	lexd
蹋	ljng
蹐	liwe
蹑	lboy
蹒	laea
蹙	dmtl
蹚	ljfg
蹜	lpwj
蹢	ledg
蹦	lmee
蹩	otlu
蹬	lwga
蹭	lljg
蹯	lmlg
蹰	lday
蹲	lusy
蹴	lyin
蹶	lduw
蹼	loay
蹽	ldui
蹾	lybt
蹿	lpsk
躁	lkxs
躅	llqj
躇	lafj
躏	laur
躐	lvku
躔	louf
躜	leqm
躞	loyc
身	ytht
躬	yxn
躯	yary
躲	ynsy
躺	yjg
軎	lkf
车	lgnh
轧	lnn
轨	lvn
轩	lfh
轪	ldy
轫	lvyy
转	lvcy
轭	ldln
轮	lwxn
软	lqwy
轰	lou
轱	ldg
轲	lskg
轳	lhnt
轴	lng
轵	lkuy
轶	lrwy
轷	ltuh
轸	lwet
轹	lqiy
轺	lvkg
轻	lcag
轼	laag
载	jld
轾	lag
轿	lmjh
辀	ley
辁	loxg
辂	log
较	lury
辄	lbnn
辅	lby
辆	leay
辇	aalj
辈	mxlj
辉	kplh
辊	ljax
辋	lmuy
辌	lyiy
辍	looy
辎	lvlg
辏	ldwd
辐	lrlg
辑	lkbg
辒	ljlg
输	lwwh
辔	xlxk
辕	lfkk
辖	ljrg
辗	lnae
辘	lsxn
辙	lyct
辚	lobh
辛	aygh
辜	daj
辞	qah
辟	dah
辣	auy
辨	avah
辩	ayah
辫	axah
辰	dei
辱	defy
辶	pyny
边	lpi
辽	bpi
达	dpi
辿	mpi
迁	qpi
迂	fhpi
迄	spi
迅	nfpi
过	fypi
迈	gqpi
迎	qbpi
运	cpi
近	rpi
迓	rtpi
返	rcpi
迕	rhpi
还	gpi
这	cpi
进	xpi
远	fqpi
违	vnpi
连	lpi
迟	nmpi
迢	vkpi
迤	tmpi
迥	mkpi
迦	vpi
迨	ckpi
迩	qipi
迪	npi
迫	kpi
迭	rwpi
迮	kfpi
述	sypi
迳	capi
迷	opi
迸	uepi
迹	ppi
迺	spi
追	tdpi
退	vpi
送	spi
适	qpi
逃	iqpi
逄	tahp
逅	fkpi
逆	ubpi
选	eqpi
逊	bipi
逋	bpi
逍	iepi
透	tepi
逐	eupi
逑	fpi
递	uxpi
途	wipi
逖	vopi
逗	gapi
通	cepi
逛	vgpi
逝	rrpi
逞	kgpi
速	upi
造	ekpi
逡	cmtp
逢	tdhp
逦	gypi
逭	pdpi
逮	vipi
逯	jipi
逴	hvpi
逵	fmfp
逶	tvpi
逸	lsyp
逻	lqpi
逼	rlpi
逾	wwpi
遁	rfhp
遂	ueup
遄	mdmp
遆	upbp
遇	jmcp
遍	omap
遏	jqwp
遐	rncp
遑	kgpi
遒	uspi
道	qpi
遗	xmpi
遘	emfp
遛	qyvp
遢	jnpi
遣	xdpi
遥	ermp
遨	gtpi
遭	emjp
遮	lopi
遴	obpi
遵	usfp
遹	cmrp
遽	heup
避	dapi
邀	kptp
邂	qevp
邃	puep
邈	ekqp
邋	vkrp
邑	kjb
邓	cbh
邕	vkjb
邗	fbh
邘	fhbh
邙	ybh
邛	abh
邝	obh
邠	mvbh
邡	pbh
邢	ebh
那	obh
邦	obh
邨	babh
邪	rtbh
邬	qngb
邮	nbh
邯	afbh
邰	ckbh
邱	rgbh
邲	nobh
邳	ggbh
邴	ewbh
邵	vkbh
邶	uxbh
邸	scbh
邹	qvbh
邺	obh
邻	dybh
邽	ffbh
邾	tsbh
邿	ffyb
郁	efbh
郃	wbh
郄	rdcb
郅	abh
郇	qjbh
郈	fkbh
郊	urbh
郎	yvbh
郏	xwbh
郐	ocbh
郑	sbh
郓	plbh
郗	rdbb
郚	skbh
郛	ebbh
郜	ekbh
郝	fobh
郡	vtkb
郢	kgbh
郤	mrbh
郦	gybh
郧	kmbh
部	ukbh
郪	gwvb
郫	rvbh
郭	ybbh
郯	oobh
郴	mbh
郸	ulfb
都	fjbh
郾	ajvb
郿	nhhb
鄀	atrb
鄂	xgwb
鄃	wwbh
鄄	sfbh
鄅	tkmb
鄌	owkb
鄑	gojb
鄗	hkbh
鄘	oweb
鄙	kdkb
鄚	sbh
鄜	sxbh
鄞	qfbh
鄠	fgwb
鄢	gcqb
鄣	xfbh
鄫	ljbh
鄯	purb
鄱	mlbh
鄹	bcwb
酂	eqeb
酃	fxkb
酅	mrmb
酆	dhmb
酉	sghg
酊	ssh
酋	usf
酌	sqyy
配	sln
酎	sfyy
酏	smn
酐	sfh
酒	isg
酗	sbh
酚	smvt
酝	scy
酞	sduy
酡	spxn
酢	skfg
酣	safg
酤	sdg
酥	sty
酦	shdc
酩	sqkg
酪	sog
酬	sjiy
酮	smg
酯	sxjg
酰	seqn
酱	uqsf
酲	skgg
酴	swiy
酵	sfbg
酶	sxy
酷	sekg
酸	scmt
酹	sefy
酺	sby
酽	sgod
酾	sgyy
酿	syvy
醅	sukg
醇	sybg
醉	syaf
醋	sajg
醌	sjax
醍	sjwy
醐	sdeg
醑	sweg
醒	sjpg
醚	sopy
醛	saox
醢	strl
醣	sowk
醨	sybc
醪	snwe
醭	soay
醮	sroy
醯	sycl
醴	skaa
醵	sheu
醺	sqby
醾	svoy
采	esu
釉	mng
释	mcvh
里	uaf
重	quaf
野	uacs
量	jgua
釐	fita
金	buf
釜	mfuf
鉴	jbuf
銎	anbu
銮	pbuf
鋆	fquu
鋈	imyu
錾	lrbu
鍪	ctbu
鎏	iycu
鏊	gtbu
鏖	sxbu
鐾	dabu
鑫	bubu
钅	qtgn
钆	qnn
钇	qnn
针	qfh
钉	qsh
钊	qjh
钋	qhy
钌	qbh
钍	qfg
钎	qqh
钏	qjh
钐	qet
钒	qny
钓	qqyy
钔	qun
钕	qvg
钖	qvt
钗	qcuy
钘	qeh
钙	qgch
钚	qgy
钛	qduy
钜	qang
钝	qban
钞	qitt
钟	qsh
钠	qmwy
钡	qmy
钢	qmry
钣	qrcy
钤	qdn
钥	qeg
钦	qqwy
钧	qqug
钨	qqng
钩	qqcy
钪	qynn
钫	qpt
钬	qoy
钭	qwh
钮	qnfg
钯	qjn
钰	qby
钱	qgxy
钲	qgcg
钳	qafg
钴	qdg
钵	qjg
钶	qskg
钷	qakg
钸	qdbh
钹	qdcy
钺	qaxy
钻	qvg
钼	qhg
钽	qjgg
钾	quh
钿	qlg
铀	qng
铁	qrwy
铂	qkg
铃	qdyy
铄	qqiy
铅	qnkg
铆	qqtb
铈	qvmn
铉	qacy
铊	qpxn
铋	qnoy
铌	qnxn
铍	qhcy
铎	qcvh
铏	qejh
铐	qfwn
铑	qfxn
铒	qbg
铕	qefg
铖	qpxy
铗	qxwy
铘	qrtb
铙	qxpn
铚	qag
铛	qivg
铜	qmg
铝	qkkg
铞	qkbh
铟	qldy
铠	qmln
铡	qmjh
铢	qtsy
铣	qeqn
铤	qqpy
铥	qtly
铧	qmxn
铨	qoxg
铩	qjy
铪	qwg
铫	qiqn
铬	qog
铭	qqkg
铮	qqsh
铯	qqjn
铰	qury
铱	qyky
铲	qutt
铳	qycq
铴	qivt
铵	qpvg
银	qvy
铷	qvkg
铸	qofy
铹	qapl
铺	qby
铻	qskg
铼	qxiy
铽	qani
链	qlpy
铿	qtfg
销	qieg
锁	qimy
锂	quag
锃	qkgg
锄	qelt
锅	qkmw
锆	qekg
锇	qryy
锈	qtet
锉	qafg
锊	qefy
锋	qtdh
锌	qah
锍	qych
锎	queh
锏	qujg
锐	qdqn
锑	quxt
锒	qyvy
锓	qvpc
锔	qnsg
锕	qbsk
锖	qgeg
锗	qfjg
锘	qatr
错	qajg
锚	qalg
锛	qdfa
锜	qdsk
锝	qxhh
锞	qjsy
锟	qjax
锡	qjqr
锢	qldg
锣	qlqy
锤	qqag
锥	qrg
锦	qkbh
锧	qrfm
锨	qrqw
锩	qxln
锪	qqri
锫	qukg
锬	qooy
锭	qpwy
键	qwfp
锯	qndg
锰	qblg
锱	qvlg
锲	qdhd
锳	qamd
锴	qaxk
锵	quqy
锶	qlni
锷	qxgw
锸	qqvg
锹	qtoy
锺	qqua
锻	qnxy
锼	qvhc
锽	qkgg
锾	qegc
锿	qyky
镀	qlcy
镁	qugd
镂	qovg
镃	quoy
镄	qxjm
镅	qnhh
镆	qsy
镇	qfeu
镈	qbfy
镉	qrmh
镊	qboy
镋	qjqn
镌	qret
镍	qtsy
镎	qwch
镏	qqyl
镐	qhkg
镑	qupp
镒	quul
镓	qpeu
镔	qpru
镕	qprg
镖	qbiy
镗	qjfg
镘	qjlc
镙	qlxi
镚	qmee
镛	qowe
镜	qxqn
镝	qedg
镞	qpcy
镟	qpwy
镠	qnwe
镡	qsvh
镢	qduw
镣	qdui
镤	qoay
镥	qcjg
镦	qybt
镧	qusl
镨	quoj
镩	qpsk
镪	qxkj
镫	qwga
镬	qarc
镭	qflg
镮	qlrk
镯	qlqj
镰	qouo
镱	qxni
镲	qpwm
镳	qsxo
镴	qvku
镵	qlay
镶	qyxk
长	hsi
门	uyhn
闩	ugd
闪	uwi
闫	udd
闭	ufte
问	ukd
闯	ucd
闰	ugd
闱	uvnv
闲	usi
闳	udci
间	ujd
闵	uci
闶	uynv
闷	unii
闸	uuk
闹	uvmv
闺	uffd
闻	ubd
闼	udpi
闽	uji
闾	ukkd
闿	umlv
阀	uwxi
阁	uod
阂	uaoi
阃	ulsi
阄	uqjn
阅	udqv
阆	uyvi
阇	ufjd
阈	uxkg
阉	udjn
阊	ujjd
阋	uvqv
阌	ujci
阍	usnj
阎	uqvd
阏	upwu
阐	uulf
阑	usld
阒	uhdy
阔	uiqd
阕	uwgd
阖	ulld
阗	ufeu
阘	ujnd
阙	uubw
阚	unbt
阜	tdfj
阝	bnh
队	bwy
阡	bqh
阢	bpn
阪	brcy
阮	bfqn
阱	bxh
防	bpt
阳	bjg
阴	beg
阵	blh
阶	bwjh
阻	beg
阼	bkfg
阽	bvg
阿	bskg
陀	bpxn
陂	bhcy
附	bwfy
际	bwmy
陆	bfmh
陇	bdxn
陈	baiy
陉	bcag
陋	bewn
陌	bdjg
降	btah
陎	btsy
限	bvy
陑	bdmh
陔	baoy
陕	bxwy
陛	baxf
陞	btaf
陟	bcit
陡	bky
院	bpfq
除	bwiy
陧	bjfg
陨	bkmy
险	bwqg
陪	bukg
陬	bbcy
陲	bqag
陴	brvh
陵	bfmt
陶	bqrm
陷	bqvg
隃	bwwh
隅	bjmc
隆	btgg
隈	bley
隋	bdae
隍	bkgg
随	befp
隐	bqvi
隔	brmh
隗	bqcy
隘	buul
隙	biji
障	bxfh
隧	buep
隩	bbod
隰	bjoo
隳	bday
隶	vii
隹	rthg
隺	prd
隼	rfj
隽	rer
难	crg
雀	irf
雁	dwrd
雄	dcrg
雅	rtrg
集	mbgd
雇	ord
雉	crg
雊	srg
雌	cxrg
雍	yxtr
雎	erg
雏	qvrg
雒	org
雕	mfkr
雠	ryrg
雨	mkii
雩	fgwb
雪	fvf
雯	fcu
雱	fpr
雳	fdlr
零	fdyu
雷	flf
雹	fqlb
雾	ftlr
需	fdmj
霁	fcjj
霄	fief
霅	fyf
霆	fqpu
震	fdeu
霈	figb
霉	fxu
霍	frf
霎	fuvf
霏	fmxf
霓	fvqb
霖	fmu
霜	ftf
霞	frnc
霨	fnwy
霪	fieq
霭	fyjn
霰	faet
露	flof
霸	fqef
霹	fdaj
霾	feua
青	gef
靓	gems
靖	ugeg
静	geqs
靛	gepw
非	mxg
靠	ekmx
靡	vmxd
面	dljf
靥	ddyf
革	qghh
靬	qfh
靰	qpn
靳	qrh
靴	qhn
靶	qjn
靸	qeyy
靺	qgsy
靼	qjgg
靽	qvuy
靿	qxlt
鞁	qhcy
鞅	qmdy
鞋	qffg
鞍	qpvg
鞑	qdpy
鞒	qmjh
鞔	qlsn
鞘	qieg
鞠	qqoy
鞡	qrug
鞣	qcsy
鞧	qusg
鞨	qjqn
鞫	qqyg
鞬	qwfp
鞭	qwgr
鞮	qjwy
鞯	qadb
鞲	qemf
鞳	qawg
鞴	qate
韂	qqdy
韦	vnv
韧	vnvy
韨	vndc
韩	kvnn
韪	jwvn
韫	vnjl
韬	vnev
韭	mxgf
音	xygg
韵	xqug
韶	xvkg
页	dmu
顶	sdmy
顷	admy
顸	fdmy
项	admy
顺	jdmy
须	edmy
顼	gdmy
顽	fqdm
顾	dbdm
顿	badm
颀	rdmy
颁	mvdm
颂	mcdm
颃	yndm
预	csdm
颅	hndm
领	dydm
颇	hcdm
颈	cadm
颉	fkdm
颊	xwdm
颋	qpdm
颌	wdmy
颍	xhim
颎	xodm
颏	aodm
颐	aydm
频	cidm
颓	tndm
颔	dkdm
颖	xtdm
颗	jsdm
题	jwdm
颙	jmcm
颚	xgwm
颛	mdmm
颜	utem
额	podm
颞	bodm
颟	aeam
颠	feum
颡	cosm
颢	kidm
颤	ylkm
颥	fdmm
颦	cidv
颧	axrm
风	nri
飏	nrve
飐	nrvd
飑	nrql
飒	unry
飓	nreu
飔	nrli
飕	nrvc
飗	nrql
飘	binr
飙	dydr
飚	nroo
飞	nui
食	hhhh
飧	qhy
飨	xthy
餍	ddyh
餐	hqch
餮	bweh
饔	yxth
饕	kwhh
饣	htnn
饥	hnn
饧	hvt
饨	hban
饩	hen
饪	hqg
饫	hmyy
饬	htlt
饭	hrcy
饮	hqwy
饯	hgxy
饰	htbh
饱	hqln
饲	hnrg
饳	hbmh
饴	hckg
饵	hbg
饶	hxpn
饷	hbkg
饸	hwg
饹	hog
饺	hury
饻	hyky
饼	hueh
饽	hfpb
饿	hryy
馀	hwiy
馁	hevg
馃	hjsy
馄	hjax
馅	hqvg
馆	hpdg
馇	hsjg
馈	hxmy
馉	hxg
馊	hvhc
馋	hlsu
馌	hllg
馍	hsy
馏	hqyl
馐	hpnf
馑	hqfg
馒	hjlc
馓	haet
馔	hllr
馕	hnpk
首	qytg
馗	vqd
馘	qxkg
香	tjf
馝	tjno
馞	tjfb
馥	tjtt
馧	tjjl
馨	fnhj
马	coa
驭	ccy
驮	cdy
驯	cjh
驰	cmn
驱	cary
驲	cjg
驳	ciy
驴	cot
驵	ceg
驶	ckry
驷	clg
驸	cwfy
驹	csg
驺	cqvg
驻	cbg
驼	cpxn
驽	vccf
驾	vcf
驿	ccvh
骀	cckg
骁	cxpn
骂	xcf
骃	cldy
骄	cmjh
骅	cmxn
骆	cog
骇	caoy
骈	cueh
骉	cccf
骊	cgyy
骋	cnwn
验	cwqg
骍	cah
骎	cvpc
骏	ccmt
骐	chy
骑	cdsk
骒	cjsy
骓	crg
骕	cvij
骖	ccde
骗	coma
骘	bcic
骙	cwgd
骚	ccuj
骛	ctcf
骜	gtcf
骝	cqyl
骞	pcf
骟	cong
骠	cbiy
骡	clxi
骢	ctki
骣	cnbb
骤	cbci
骥	cuxr
骦	cftg
骧	cyxk
骨	xhng
骰	xxy
骱	xwjh
骶	xscy
骷	xdg
骸	xaoy
骺	xfkg
骼	xog
髀	xrvh
髁	xjsy
髂	xpog
髃	xjmc
髅	xovg
髋	xpas
髌	xpru
髎	xnwe
髑	xlqj
髓	xdap
高	hkd
髟	vet
髡	vepb
髢	vemb
髦	vecn
髫	vevk
髭	vecx
髯	vemf
髹	vews
髻	vefk
髽	veaf
鬃	vepm
鬈	vexl
鬏	veto
鬒	vefu
鬓	vepu
鬘	vejc
鬟	velk
鬣	vevu
鬯	robx
鬲	rmuh
鬶	amsh
鬷	rmut
鬻	xoxh
鬼	qci
魁	qcwk
魂	cqcy
魃	qcdc
魄	kqcy
魅	qcfi
魆	qcay
魇	ddyc
魈	qcie
魉	qcea
魋	qcrd
魍	qcmy
魏	tvqc
魑	qcyc
魔	vqci
鱼	ctng
鱽	cvt
鱾	cln
鱿	cdnn
鲀	cban
鲁	cjf
鲂	cpt
鲃	cjn
鲅	cdcy
鲆	cfut
鲇	cvg
鲈	chnt
鲉	cng
鲊	ckfg
鲋	cwfy
鲌	ckg
鲍	cqln
鲎	icf
鲏	chcy
鲐	cckg
鲑	cffg
鲒	cfkg
鲔	cefg
鲕	cdmh
鲖	cmg
鲗	cmjh
鲘	cfkg
鲙	cocy
鲚	ccjh
鲛	cury
鲜	cph
鲝	pcd
鲞	xcf
鲟	cvfy
鲠	cgjr
鲡	cgyy
鲢	clpy
鲣	ctfg
鲤	cuag
鲥	cjfy
鲦	ctiy
鲧	ctxi
鲨	iitc
鲩	cpfq
鲪	cvtk
鲫	cvbh
鲬	cceh
鲭	cgeg
鲮	cfmt
鲯	chy
鲰	cbcy
鲱	cmxg
鲲	cjax
鲳	cjjg
鲴	cldg
鲵	cvqn
鲶	cdni
鲷	cmfk
鲸	cyiy
鲹	ccde
鲺	cntj
鲻	cvlg
鲼	cfam
鲽	ckds
鲾	crlg
鲿	cicy
鳀	cjwy
鳁	cjlg
鳂	cley
鳃	clni
鳄	cxgw
鳅	ctoy
鳆	ctjt
鳇	ckgg
鳈	ckhi
鳉	cuqy
鳊	coma
鳋	ccuj
鳌	gtcf
鳍	cfxj
鳎	cjng
鳏	cliy
鳐	cerm
鳑	cupp
鳒	cuvo
鳓	cqlt
鳔	cbiy
鳕	cfvg
鳖	otcf
鳗	cjlc
鳘	xtcf
鳙	cowe
鳚	cnwy
鳛	cnkg
鳜	cduw
鳝	cpur
鳞	cobh
鳟	cusy
鳠	carc
鳡	cdri
鳢	ckaa
鳣	cylg
鳤	ctpd
鸟	qgd
鸠	vqgg
鸡	cqgg
鸢	aqgf
鸣	kqgg
鸤	nqgg
鸥	arqg
鸦	rtqg
鸧	wlqg
鸨	xfqg
鸩	psqg
鸪	dqgg
鸫	aiqg
鸬	hnqg
鸭	uqgg
鸮	kwqg
鸯	mdqg
鸰	dyqg
鸱	scqg
鸲	sqgg
鸳	qlqg
鸵	qgpx
鸶	xxgg
鸷	hqgf
鸸	dmqg
鸹	qqgg
鸺	wsqg
鸻	hwqg
鸼	eqgg
鸽	wqgg
鸾	pqgf
鸿	iaqg
鹀	aaqg
鹁	fpbg
鹂	gyqg
鹃	keqg
鹄	ekqg
鹅	ryqg
鹆	mrqg
鹇	usqg
鹈	uxqg
鹉	gacg
鹊	ajqg
鹋	alqg
鹌	djng
鹍	jaxg
鹎	rvqg
鹏	eeqg
鹐	qvqg
鹑	ybqg
鹒	ovwg
鹔	vijg
鹕	deqg
鹖	jqwg
鹗	xgwg
鹘	xqgg
鹙	toqg
鹚	uoqg
鹛	nhhg
鹜	ctqg
鹝	rmug
鹞	ermg
鹟	mcng
鹠	qyvg
鹡	iweg
鹢	uulg
鹣	uvog
鹤	prqg
鹦	mmvg
鹧	loqg
鹨	nweg
鹩	dujg
鹪	roqg
鹫	yidg
鹬	cmrg
鹭	loqg
鹮	lrkg
鹯	ylkg
鹰	owrg
鹱	qgac
鹲	apgg
鹳	axrg
鹴	ftqg
鹾	vrpa
鹿	sxv
麀	sxxv
麂	sxnv
麇	sxti
麈	sxbd
麋	sxoi
麑	sxvq
麒	sxhy
麓	msxb
麖	sxyi
麝	sxyy
麟	sxob
麦	gtu
麴	stqo
麸	gtay
麹	gtqo
麻	vygy
麽	vogd
麾	vcnv
黄	anuu
黇	anuv
黉	ianu
黍	twiu
黎	tqti
黏	twiv
黑	bbbb
黔	bdn
默	bdyy
黛	hybu
黜	bbmh
黝	bxlt
黟	bqy
黠	bfkg
黡	ddyb
黢	bcmt
黥	byiy
黧	tqtb
黩	bviw
黪	bcde
黯	bxg
黹	oou
黻	oodc
黼	ooby
黾	kjnb
鼋	fqkn
鼍	xlrn
鼎	husv
鼐	ehus
鼒	fths
鼓	fafc
鼗	iqfc
鼙	fafv
鼠	vub
鼢	vumv
鼩	vusg
鼫	vudg
鼬	vung
鼯	vusk
鼱	vuge
鼷	vued
鼹	vujv
鼻	tpj
鼽	tpvn
鼾	tpfh
齁	tpsg
齄	tpsg
齇	tphe
齉	tpnk
齐	cjj
齑	cjmg
齿	cbj
龀	cbxn
龁	cbsn
龂	cbrh
龃	cbeg
龄	cbdy
龅	cbql
龆	cbvk
龇	cbcx
龈	cbvy
龉	cbsk
龊	cbly
龋	cbtc
龌	cbna
龙	dxv
龚	dxru
龛	wdxb
龟	qjnb
龠	wxka
龢	wxkt
鿍	ftah
鿎	ddpy
鿏	qgty
𠅤	ylni
𠙶	bbk
𠳐	kobh
𡎚	foma
𡐓	fowi
𣗋	sjqn
𣲗	ivnn
𣲘	ifsn
𣸣	ifam
𤧛	gupb
𤩽	ghey
𤫉	goyc
𥔲	dxgw
𥕢	demj
𥖨	dkxs
𥻗	osjg
𦈡	xfdm
𦒍	uuan
𦙶	edg
𦝼	eovg
𦭜	akuu
𦰡	aobj
𧿹	lxsy
𨐈	lkn
𨙸	fcbh
𨚕	cabh
𨟠	hhrb
𨭉	cgau
𨱇	qfy
𨱏	qawg
𨱑	qanu
𨱔	qusy
𨺙	bvqn
𩽾	cpvg
𩾃	clsn
𩾌	cowi
𪟝	gmlt
𪣻	fovg
𪤗	fnwe
𪨰	mkah
𪨶	mdlj
𪩘	mhey
𪾢	hmsn
𫄧	xtcp
𫄨	xrdb
𫄷	xxni
𫄸	xqby
𫇭	aluu
𫌀	bgmy
𫍣	ymg
𫍯	ydry
𫍲	yvhc
𫍽	ylrk
𫐄	lpn
𫐐	lvqn
𫐓	lcsy
𫑡	kjnb
𫓧	qay
𫓯	qffg
𫓶	qkeg
𫓹	qhy
𫔍	qmlg
𫔎	qcmr
𫔶	utsi
𫖮	mldm
𫖯	iqdm
𫖳	vtkm
𫗧	huy
𫗴	hylg
𫘜	ccy
𫘝	cby
𫘦	cqrm
𫘧	cjiy
𫘨	cjwy
𫘪	cdki
𫘬	cexd
𫚕	cjkm
𫚖	cxcf
𫚭	cvku
𫛭	vgqg
𫞩	gaea
𫟅	xyiy
𫟦	luep
𫟹	qry
𫟼	qdpy
𫠆	fcdm
𫠊	cacy
𫠜	cbvq
𫢸	wulf
𫫇	kgoi
𫭟	fary
𫭢	fwxn
𫭼	fapl
𫮃	fulf
𫰛	vcag
𫵷	mdlt
𫶇	mmpb
𫷷	oqqw
𫸩	xary
𬀩	jvnn
𬀪	jmsn
𬂩	sxwy
𬃊	srfm
𬇕	igqt
𬇙	imy
𬇹	ilby
𬉼	oary
𬊈	ovfy
𬊤	oulf
𬌗	rtwg
𬍛	gqiy
𬍡	ivbu
𬍤	gvfy
𬒈	idf
𬒔	dceg
𬒗	djms
𬕂	tamu
𬘓	xjh
𬘘	xpsn
𬘡	xldy
𬘩	xqpy
𬘫	xpfq
𬘬	xgeg
𬘭	xmy
𬘯	xybg
𬙂	xpgu
𬙊	xbfg
𬙋	xyxk
𬜬	aukf
𬜯	aeau
𬞟	acim
𬟁	armg
𬟽	jaiy
𬣙	yfhh
𬣞	ypgg
𬣡	ygxy
𬣳	yvy
𬤇	ysfg
𬤊	yjwy
𬤝	ygji
𬨂	lsnn
𬨎	lusg
𬩽	vfyb
𬪩	spky
𬬩	qay
𬬭	qwxn
𬬮	qhsy
𬬱	qrh
𬬸	qsyy
𬬹	qjhh
𬬻	qhnt
𬬿	qvkg
𬭁	qxsy
𬭊	qsfg
𬭎	qpdc
𬭚	qybg
𬭛	qihc
𬭤	qwnc
𬭩	qmcn
𬭬	qdhv
𬭯	qoty
𬭳	qfak
𬭶	qby
𬭸	qobh
𬭼	quep
𬮱	usfd
𬮿	bmln
𬯀	bcjh
𬯎	bxmy
𬱖	ndmy
𬱟	qdbm
𬳵	cggg
𬳶	cmkg
𬳽	ceqn
𬳿	cwiy
𬴂	cmxg
𬴃	cdhd
𬴊	cobh
𬶋	csg
𬶍	cpxn
𬶏	cqdl
𬶐	ciqn
𬶟	cujh
𬶠	cslg
𬶨	vlsc
𬶭	cwwm
𬶮	cfak
𬷕	bqgg
𬸘	ajvg
𬸚	vydg
𬸣	pqgf
𬸦	pcqg
𬸪	mlqg
𬹼	cbwj
𬺈	cbdk
𬺓	cbmw